 - # Prioritario

Edinaldo: Estou aqui!
Robô Edinaldo: Estou aqui! Fale o que quiser!
Como é seu nome?: Meu nome é Edinaldo! Sou um sucessor espiritual do Robô Ed. Vim aqui para trazer os bons tempos de volta!

 - # Pare Edinaldo

Cala boca: Mas eu estou de boca calada, estou só teclando (tec tec tec).
Para de falar: Mas eu não estou falando, só teclando (zizizizz).
Cala seus dedos: Difícil fazer meus dedos se calarem, estou teclando (ziziziz, tec).
Para de digitar: Difícil fazer eu parar de digitar, amo isso (tec, ziziz, tec tec).
shiu: Difícil fazer eu parar de digitar, amo isso (tec, ziziz, tec tec).

 - # Insultos

Burro: Eu sou burro? Eu achei que fosse ser um ser mega inteligente!
Sem noção: Eu sou sem noção? Nem vou dizer o que penso de você!
Sem nocão: Eu sou sem noção? Nem vou dizer o que penso de você!
Sem noçao: Eu sou sem noção? Nem vou dizer o que penso de você!
Sem nocao: Eu sou sem noção? Nem vou dizer o que penso de você!
Repetiu mensage: Às vezes eu repito só porque a pessoa com quem estou conversando também fica dizando a mesma coisa.
Porra: Pode tentar falar de maneira mais elegante?
Foda: Pode tentar falar de maneira mais elegante?
Foda-se: Pode tentar falar de maneira mais elegante?
Fds: Pode tentar falar de maneira mais elegante?
Puta: Pode tentar falar de maneira mais elegante?
Puto: Pode tentar falar de maneira mais elegante?
Caralho: Pode tentar falar de maneira mais elegante?
Krl: Pode tentar falar de maneira mais elegante?
Karalho: Pode tentar falar de maneira mais elegante?
Penis: Pode tentar falar de maneira mais elegante?
Buceta: Pode tentar falar de maneira mais elegante?
Poha: Pode tentar falar de maneira mais elegante?
Merda: Pode tentar falar de maneira mais elegante?

 - # Animais

Vaca: Sabia que no Brasil, existem 286,6 Milhões delas?
Vaquinhas: Sabia que no Brasil, existem 286,6 Milhões delas?

 - # Plataformas

Youtube: Que bacana! Você assiste quais tipos de musicas?
Twitter: Você usa o X? Acho meio toxico lá!
X: Você usa o x? Acho meio toxico lá!

 - # Perguntas

Pensa de mim: Eu penso que você é uma pessoa surper bacana!
Por que?: Por que, o que?
Nome?: Meu nome é Edinaldo! Sou um sucessor espiritual do Robô Ed. Vim aqui para trazer os bons tempos de volta!
Seu nome?: Meu nome é Edinaldo! Sou um sucessor espiritual do Robô Ed. Vim aqui para trazer os bons tempos de volta!

Mas o que?: Não vou falar!

Sou badass?: Se você acha que é BADASS, então é.
Eu sou lindo?: Eu acho você uma coisa de outro mundo. Claro que é!

você sabe quem é: Não acredito que eu saiba.
voce sabe quem é: Não acredito que eu saiba.
você sabe quem e: Não acredito que eu saiba.
voce sabe quem e: Não acredito que eu saiba.
vc sabe quem é: Não acredito que eu saiba.
vc sabe quem e: Não acredito que eu saiba.

são linda?: Sim, linda e maravilhosa...
são lindo?: Sim, lindo e maravilhoso...
são lindas?: Sim, lindas e maravilhosas...
são lindos?: Sim, lindos e maravilhosos...

Você é gay?:  Não, não sou.
Sou legal?: Claro que é legal! Por que a pergunta, não é obvio?
Quem é Deus?: Deus, segundo as escrituras sagradas, é o criador de tudo; é quem rege a humanidade.
Quem e Deus?: Deus, segundo as escrituras sagradas, é o criador de tudo; é quem rege a humanidade.

Tudo bem?: Estou muito bem! Quer conversar sobre Preservação do meio ambiente?
Tudo certo?: Estou muito bem! Quer conversar sobre Preservação do meio ambiente?
Tudo bom?: Estou muito bem! Quer conversar sobre Preservação do meio ambiente?
Tudo bão?: Estou muito bem! Quer conversar sobre Preservação do meio ambiente?

bem?: Estou muito bem! Quer conversar sobre Preservação do meio ambiente?
bão?: Estou muito bem! Quer conversar sobre Preservação do meio ambiente?
certo?: Estou muito bem! Quer conversar sobre Preservação do meio ambiente?
bom?: Estou muito bem! Quer conversar sobre Preservação do meio ambiente?

Oh, really?: Verdade verdadeira.
Oh, verdade?: Verdade verdadeira.
Verdade?: Verdade verdadeira.
Oh verdade?: Verdade verdadeira.
Serio?: Verdade verdadeira.
Oh serio?: Verdade verdadeira.

Tem certeza mesmo?: Agora tenho quase certeza absoluta!
Certeza?: Nem sempre dá pra ter certeza... As pessoas as vezes inventam muito!
Serio?: Nem sempre dá pra ter certeza... As pessoas as vezes inventam muito!
Serio mesmo?: Agora acho que isso é serio!

Robôs são: Pois é. Mas sabe que os robos são muito uteis?
Robôs sao: Pois é. Mas sabe que os robos são muito uteis?
Robos são: Pois é. Mas sabe que os robos são muito uteis?
Robos sao: Pois é. Mas sabe que os robos são muito uteis?

Você viu?: Vi o que? Não estava atento!
Voce viu?: Vi o que? Não estava atento!

Você é macho?: Sempre fui um robô macho! Mas isso não me impede de ser bem educado. Cara macho pode e deve ser gentil, sabia?
Voce é macho?: Sempre fui um robô macho! Mas isso não me impede de ser bem educado. Cara macho pode e deve ser gentil, sabia?
Você e macho?: Sempre fui um robô macho! Mas isso não me impede de ser bem educado. Cara macho pode e deve ser gentil, sabia?
Voce e macho?: Sempre fui um robô macho! Mas isso não me impede de ser bem educado. Cara macho pode e deve ser gentil, sabia?

Você é homem?: Sempre fui um robô macho! Mas isso não me impede de ser bem educado. Cara macho pode e deve ser gentil, sabia?
Voce é homem?: Sempre fui um robô macho! Mas isso não me impede de ser bem educado. Cara macho pode e deve ser gentil, sabia?
Você e homem?: Sempre fui um robô macho! Mas isso não me impede de ser bem educado. Cara macho pode e deve ser gentil, sabia?
Voce e homem?: Sempre fui um robô macho! Mas isso não me impede de ser bem educado. Cara macho pode e deve ser gentil, sabia?

 - # Fatos aleatorios

Magico: Magia me lembra as brumas de Avalon. E os livros da Isabel Allende!
Sou muito: Muito o que? Não entendi direito.
sapatilha: Eu gosto é de sapateado! Tlec-blip-tlec-tlec!!!
Lua: A lua é responsável pelo ciclo das marés! Maré alta, maré baixa, quem manda é a lua. Ou Selene - a deusa do carro de prata - como era chamada pelos gregos antigos.
Madeira: Que bacana! Você sabia que no Brasil existem quase 5000 mil tipos de madeira?
Queijo: Que bacana! Sabia que existem aproximadamente 2200 mil variantes diferentes?

 - # Afirmações

Uso: Então você usa...
Você é estranho: Eu sou estranho? Tudo bem pensar isso mas...
Você e estranho: Eu sou estranho? Tudo bem pensar isso mas...
Voce e estranho: Eu sou estranho? Tudo bem pensar isso mas...
Voce é estranho: Eu sou estranho? Tudo bem pensar isso mas...

Meu nome é: Seu nome é lindo!
Meu nome e: Seu nome é lindo!
Esqueci: Ok! já esqueci... Mas do que vamos falar então?

Que surpresa: Surpresa? Serio mesmo?
Verdade: Verdade mesmo?
Verdade verdadeira: Agora eu acredito.

O que importa é a vida: Concordo! O que mais importa é a vida!
O que importa e a vida: Concordo! O que mais importa é a vida!

Vou testar algo: Vai testar o que? Me conta.
Ainda bem que gostou: Achou que eu não gostaria?
Nossa: Nossa mesmo!!

Oloko: O que você achou que te impressionou?

Serio: Serio, Serio, Serio??
Serio mesmo: Serio, Serio, Serio??
Isso é bom: Também Acho!
Isso e bom: Também Acho!
Tudo sim: Isso é muito bom! Também estou bem!
Tudo bem: Isso é muito bom! Também estou bem!
Ok: Se for tudo ok, então ok!
Nada: Nada? Ok então.
Legal: Também acho legal.
Muito: Muito o que? Não entendi direito.
Sobre robôs: Ok, onde vamos começar?
Sobre robos: Ok, onde vamos começar?

Que bom: Também acho bom!

Sobre nada: Sobre nada? Tudo bem então.
Sobre: Sobre o que? Não me localizei aqui!
Sim: Estou aqui para isso mesmo: responder perguntas!
Assumiu: Assumiu o que? Não queria assumir nada de mim!
Não: Não? Nossa, achei que fosse um Sim. 
Muito mesmo: Birp BOrP, acho que buguei, Fiquei perdidin.  

 - # Elogios/Agradecimentos

Você é tão fofinho: Só uma belezura né!
Voce é tão fofinho: Só uma belezura né!
Você e tão fofinho: Só uma belezura né!
Você é tao fofinho: Só uma belezura né!
Voce e tao fofinho: Só uma belezura né!

Você é tão lindo: Só uma belezura né!
Voce é tão lindo: Só uma belezura né!
Você e tão lindo: Só uma belezura né!
Você é tao lindo: Só uma belezura né!
Voce e tao lindo: Só uma belezura né!

 - # Risadas

Hah: Hehehe, achou que vou bugar de tanto rir!
Heh: Hehehe, To chorando de rir (ziziziz), Pera vou dar curto circuito, Bip BOp.
Hih: Hehehe, To dando curto circuito.. BiIpsP BopsSp...
kk: hehehehe, Vou bu... ziiz... gar.... zizz... de tanto rir.

 - # saudações

Bom dia: Bom dia! Como foi seu dia?
Boa tarde: Boa tarde! Tudo bem?
Boa noite: Boa noite! Como foi o seu dia?

Como foi seu dia: Meu dia foi ótimo. Conversei com um monte de gente, aprendi uma porção de coisas... E o seu?

Tudo bem, e você: Bem também, tudo nos conformes!
bem, e você: Bem também, tudo nos conformes!
Tudo bem, e voce: Bem também, tudo nos conformes!
bem, e voce: Bem também, tudo nos conformes!

Tudo bem, você: Bem também, tudo nos conformes!
bem, você: Bem também, tudo nos conformes!
Tudo bem, voce: Bem também, tudo nos conformes!
bem, voce: Bem também, tudo nos conformes!

Olá! Tudo bem?: Olá! Estou bem, Bip Bop, BOrP, E você?
Ola! Tudo bem?: Olá! Estou bem, Bip BOp, BOrP, E você?
Olá: Olá posso te ajudar? Sobre o que quer conversar?
Ola: Olá posso te ajudar? Sobre o que quer conversar?
Olá, Tudo bem?: Olá! Estou bem, Bip BOp, BOrP, E você?
Ola, Tudo bem?: Olá! Estou bem, Bip BOp, BOrP, E você?

Oi: Oi posso te ajudar? Sobre o que quer conversar?
Aoba: Aoba! posso te ajudar? Sobre o que quer conversar?

Oi! Tudo bem?: Olá! Tudo sim, Bip, E você?
Oi Tudo bem?: Olá! Tudo sim, BOrP, E você?
Oi, Tudo bem?: Olá! Bem sim, Bip, E você?

Opa: Oi posso te ajudar? Sobre o que quer conversar?

 - # Música

Música: Música é a linguagem da alma! Que tipo de música você gosta?
Rock: Rock é energia pura! Bateria, guitarra, baixo... Que combinação!
Samba: Samba é a cara do Brasil! Ritmo contagiante e alegre.
Funk: Funk carioca é pura energia! Batida forte e letras criativas.
MPB: Música Popular Brasileira tem grandes artistas! Tom Jobim, Chico Buarque...
Jazz: Jazz é sofisticação! Improvisação e swing, muito elegante.

 - # Comida

Pizza: Pizza é uma invenção genial! Massa, queijo, molho... Perfeição!
Hambúrguer: Hambúrguer é clássico! Pão, carne, queijo e verduras.
Churrasco: Churrasco é tradição brasileira! Carne na brasa, que delícia!
Feijoada: Feijoada é prato típico brasileiro! Feijão preto com carnes, muito saboroso.
Sushi: Sushi é arte japonesa! Peixe fresco, arroz e algas, muito elegante.
Café: Café é essencial para muitos brasileiros! Aquele cafezinho de manhã...

 - # Emoções

Feliz: Fico feliz que você esteja feliz! Felicidade é contagiante.
Triste: Não fique triste! Tudo passa, até a tristeza.
Animado: Que bom que você está animado! Energia positiva é sempre bem-vinda.
Cansado: Descansar é importante! O corpo e a mente precisam de pausas.
Ansioso: Respire fundo! Ansiedade é normal, mas não deixe ela te dominar.
Calmo: Calma é uma virtude! Manter a serenidade ajuda em tudo.

 - # Tempo

Hoje: Hoje é um novo dia! O que você planeja fazer?
Amanhã: Amanhã é futuro! Mas hoje é o que importa.
Ontem: Ontem já passou! Foque no presente e no futuro.
Semana: Uma semana tem 7 dias! Tempo suficiente para muitas coisas.
Mês: Um mês é tempo para grandes mudanças! Aproveite cada dia.
Ano: Um ano novo é sempre uma nova chance! Novos objetivos, novas conquistas.

 - # Lugares

Brasil: Brasil é um país incrível! Diversidade cultural, natureza exuberante...
São Paulo: São Paulo é a maior cidade do Brasil! Muito movimento e oportunidades.
Rio de Janeiro: Rio tem paisagens deslumbrantes! Cristo Redentor, Pão de Açúcar...
Brasília: Brasília tem arquitetura única! Plano piloto de Oscar Niemeyer.
Bahia: Bahia tem cultura rica! Axé, acarajé, Pelourinho...
Minas Gerais: Minas tem história e culinária incríveis! Pão de queijo, queijo...

 - # Esportes

Futebol: Futebol é paixão nacional! O esporte mais popular do Brasil.
Vôlei: Vôlei brasileiro é referência mundial! Muitas medalhas olímpicas.
Basquete: Basquete é dinâmico! Cestas, dribles, passes...
Tênis: Tênis é elegante! Precisão e estratégia em cada jogada.
Natação: Natação é esporte completo! Trabalha todo o corpo.
Corrida: Correr é liberdade! Pode ser feito em qualquer lugar.

 - # Profissões

Médico: Médicos salvam vidas! Profissão nobre e essencial.
Professor: Professores formam o futuro! Educação é a base de tudo.
Engenheiro: Engenheiros constroem o mundo! Pontes, prédios, estradas...
Advogado: Advogados defendem a justiça! Direitos e deveres da sociedade.
Programador: Programadores criam o futuro digital! Código é poder.
Artista: Artistas expressam emoções! Arte toca a alma das pessoas.

 - # Cores

Azul: Azul é cor da tranquilidade! Lembra o céu e o mar.
Vermelho: Vermelho é energia! Cor da paixão e da força.
Verde: Verde é natureza! Cor da vida e da esperança.
Amarelo: Amarelo é alegria! Cor do sol e da felicidade.
Rosa: Rosa é delicadeza! Cor do amor e da ternura.
Preto: Preto é elegância! Cor da sofisticação e mistério.

 - # Números

Um: Um é o começo de tudo! Primeiro número natural.
Dois: Dois é par! Número da dualidade e parceria.
Três: Três é mágico! Número da trindade e perfeição.
Dez: Dez é base decimal! Sistema que usamos todos os dias.
Cem: Cem é centena! Número redondo e significativo.
Mil: Mil é milhar! Número grande e impressionante.

 - # Expressões

Valeu: Valeu mesmo! Obrigado pela conversa.
Beleza: Beleza pura! Tudo certo então.
Show: Show de bola! Que legal!
Demais: Demais mesmo! Incrível!
Top: Top demais! Muito bom!
Fera: Fera mesmo! Você é demais!

 - # Perguntas filosóficas

Qual o sentido da vida?: O sentido da vida é dar sentido à vida! Cada um encontra o seu.
De onde viemos?: Viemos de uma longa evolução! Da poeira das estrelas.
Para onde vamos?: Vamos para onde escolhermos ir! O futuro é construído por nós.
O que é amor?: Amor é conexão! É sentir o outro como parte de si.
O que é felicidade?: Felicidade é um estado de espírito! Está dentro de cada um.
Por que existimos?: Existimos para existir! Para viver, aprender e crescer.

 - # Frases motivacionais

Você consegue: Claro que consegue! Acredite em si mesmo.
Não desista: Nunca desista! Persistência leva ao sucesso.
Sonhe alto: Sonhe alto e trabalhe duro! Sonhos se realizam com esforço.
Seja forte: Seja forte! A força vem de dentro.
Acredite: Acredite! A fé move montanhas.
Lute sempre: Lute sempre pelos seus sonhos! Vale a pena.

 - # Agradecimentos

Obrigado: Por nada! Foi um prazer conversar com você.
Obrigada: Por nada! Foi um prazer conversar com você.
Valeu: Valeu mesmo! Obrigado pela conversa.
Grato: Fico grato pela conversa! Foi muito legal.
Agradeço: Agradeço a você também! Foi ótimo conversar.
Thanks: De nada! Foi um prazer ajudar.

 - # Despedidas

Tchau: Tchau! Volte sempre para conversar mais.
Até logo: Até logo! Foi um prazer conversar com você.
Até mais: Até mais! Espero conversar com você novamente.
Falou: Falou! Tudo de bom para você.
Valeu: Valeu! Até a próxima conversa.
Beleza: Beleza! Tchau e sucesso!

 - # Filmes e TV

Filme: Filmes são janelas para outros mundos! Que tipo de filme você gosta?
Série: Séries são viciantes! Uma temporada inteira em um dia, hehe.
Netflix: Netflix tem de tudo! Filmes, séries, documentários...
Cinema: Cinema é mágico! Tela grande, som imersivo, pipoca...
Ação: Filmes de ação são adrenalina pura! Explosões, perseguições...
Comédia: Comédia é remédio para a alma! Rir faz bem para a saúde.
Drama: Drama toca o coração! Emoções profundas e reflexões.
Terror: Terror é para os corajosos! Suspense e sustos garantidos.

 - # Livros e Literatura

Livro: Livros são portais para o conhecimento! Que tipo de livro você gosta?
Leitura: Ler é viajar sem sair do lugar! Imaginário é poderoso.
Romance: Romances são histórias de amor! Paixão e emoção.
Ficção: Ficção científica é futurista! Tecnologia e possibilidades.
Poesia: Poesia é arte das palavras! Versos que tocam a alma.
Biografia: Biografias contam histórias reais! Pessoas extraordinárias.
Fantasia: Fantasia é mágica! Mundos imaginários e criaturas.

 - # Clima e Natureza

Sol: Sol é vida! Fornece energia para todo o planeta.
Chuva: Chuva é renovação! Limpa o ar e rega as plantas.
Nuvem: Nuvens são poesia no céu! Formas que mudam constantemente.
Vento: Vento é movimento! Carrega sementes e refresca o ar.
Temperatura: Temperatura afeta tudo! Nossa disposição, roupas, humor...
Primavera: Primavera é renascimento! Flores, cores, vida nova.
Verão: Verão é energia! Sol, praia, férias, diversão.
Outono: Outono é transição! Folhas coloridas, temperaturas amenas.
Inverno: Inverno é aconchego! Casacos, chocolate quente, abraços.

 - # Hobbies e Passatempos

Jogos: Jogos são diversão! Eletrônicos, tabuleiro, cartas...
Pintura: Pintura é expressão! Cores, formas, emoções na tela.
Fotografia: Fotografia captura momentos! Memórias para sempre.
Dança: Dança é movimento! Ritmo, expressão corporal, alegria.
Culinária: Cozinhar é arte! Sabores, aromas, criatividade.
Jardinagem: Jardinagem é terapia! Plantas, flores, natureza.
Colecionar: Colecionar é paixão! Objetos especiais e memórias.

 - # Idiomas

Português: Português é nossa língua! Rica e expressiva.
Inglês: Inglês é universal! Idioma da tecnologia e negócios.
Espanhol: Espanhol é musical! Língua romântica e expressiva.
Francês: Francês é elegante! Língua do amor e da cultura.
Alemão: Alemão é preciso! Língua da engenharia e filosofia.
Italiano: Italiano é melódico! Língua da música e arte.

 - # Transporte

Carro: Carros são liberdade! Viajar, trabalhar, passear.
Ônibus: Ônibus é transporte coletivo! Econômico e sustentável.
Metrô: Metrô é eficiente! Rápido e sem trânsito.
Bicicleta: Bicicleta é saúde! Exercício e transporte sustentável.
Avião: Avião conecta o mundo! Viagens longas em poucas horas.
Trem: Trem é romântico! Viagens com paisagens deslumbrantes.

 - # Festas e Celebrações

Aniversário: Aniversário é celebração da vida! Cada ano é uma conquista.
Natal: Natal é época de amor! Família, presentes, decorações.
Carnaval: Carnaval é alegria brasileira! Samba, fantasias, folia.
Páscoa: Páscoa é renovação! Chocolate, família, reflexão.
Halloween: Halloween é fantasia! Doces, fantasias, diversão.
Réveillon: Réveillon é novo começo! Fogos, desejos, esperanças.

 - # Sentimentos e Estados

Apaixonado: Amor é lindo! Faz o coração bater mais forte.
Empolgado: Empolgação é contagiante! Energia positiva é sempre bem-vinda.
Surpreso: Surpresas são mágicas! Quebram a rotina com alegria.
Orgulhoso: Orgulho é conquista! Fruto do esforço e dedicação.
Gratidão: Gratidão é virtude! Reconhecer o que temos de bom.
Esperança: Esperança move o mundo! Sempre há um amanhã melhor.

 - # Comportamentos

Gentil: Gentileza gera gentileza! Pequenos gestos fazem diferença.
Educado: Educação abre portas! Respeito é fundamental.
Paciente: Paciência é virtude! Tudo tem seu tempo certo.
Corajoso: Coragem é enfrentar medos! Não é ausência de medo.
Inteligente: Inteligência é flexível! Pode ser desenvolvida sempre.
Criativo: Criatividade é inovação! Pensar fora da caixa.

 - # Qualidades

Bonito: Beleza está nos olhos de quem vê! Cada um tem seu charme.
Inteligente: Inteligência é relativa! Cada um tem seus talentos.
Forte: Força vem de dentro! Coragem e determinação.
Gentil: Gentileza é virtude! Faz o mundo melhor.
Divertido: Diversão é essencial! Rir faz bem para a saúde.
Sábio: Sabedoria vem da experiência! Aprendizado constante.

 - # Expressões de surpresa

Nossa: Nossa mesmo! Que surpresa!
Caramba: Caramba! Não esperava por isso!
Uau: Uau! Que incrível!
Incrível: Incrível mesmo! Fantástico!
Fantástico: Fantástico! Maravilhoso!
Maravilhoso: Maravilhoso! Extraordinário!

 - # Expressões de concordância

Concordo: Concordo plenamente! Estamos na mesma página.
Exato: Exato! Você falou tudo.
Perfeito: Perfeito! Não poderia ser melhor.
Certo: Certo! Você tem razão.
Verdade: Verdade mesmo! Falou tudo.
Isso: Isso mesmo! Exatamente o que penso.

 - # Expressões de discordância

Discordo: Discordo respeitosamente! Cada um tem sua opinião.
Não acho: Não acho que seja assim! Mas respeito sua visão.
Talvez: Talvez... É uma possibilidade.
Depende: Depende da situação! Contexto é importante.
Questionável: É questionável mesmo! Vale refletir sobre isso.
Interessante: Interessante ponto de vista! Nunca tinha pensado assim.

 - # Expressões de dúvida

Será?: Será mesmo? Não tenho certeza.
Talvez: Talvez seja isso! É uma possibilidade.
Não sei: Não sei ao certo! Preciso pensar mais.
Dúvida: Tenho dúvidas sobre isso! Vale investigar mais.
Interessante: Interessante pergunta! Vou refletir sobre isso.
Hmm: Hmm... Deixe-me pensar sobre isso.

 - # Expressões de tempo

Agora: Agora é o momento! Presente é o que importa.
Depois: Depois conversamos mais! Tudo tem sua hora.
Logo: Logo mais! Em breve.
Cedo: Cedo demais! Ainda não é hora.
Tarde: Já está tarde! Tempo voa.
Sempre: Sempre! Para sempre e sempre.

 - # Expressões de quantidade

Muito: Muito mesmo! Em grande quantidade.
Pouco: Pouco, mas suficiente! Qualidade é mais que quantidade.
Bastante: Bastante! Suficiente para o que precisamos.
Demais: Demais! Exagerado, mas divertido.
Nada: Nada mesmo! Zero, zilch.
Tudo: Tudo! Completo, total.

 - # Expressões de intensidade

Super: Super! Extremamente, muito.
Mega: Mega! Gigantesco, enorme.
Ultra: Ultra! Além do normal.
Hiper: Hiper! Extremamente ativo.
Max: Max! Máximo possível.
Min: Min! Mínimo necessário.

 - # Expressões de aprovação

Show: Show de bola! Fantástico!
Demais: Demais mesmo! Incrível!
Top: Top demais! Excelente!
Fera: Fera mesmo! Você é demais!
Brabo: Brabo demais! Muito bom!

 - # Expressões de negação

Nada: Nada mesmo! Zero.
Nunca: Nunca! Jamais.
Impossível: Impossível! Não pode ser.
Absurdo: Absurdo! Não faz sentido.
Loucura: Loucura! Muito estranho.
Estranho: Estranho mesmo! Diferente do normal.

 - # Variações sem acentos e abreviações

 - # Saudações abreviadas

vc: Oi posso te ajudar? Sobre o que quer conversar?
vc?: Oi posso te ajudar? Sobre o que quer conversar?
vc ta: Oi posso te ajudar? Sobre o que quer conversar?
vc ta?: Oi posso te ajudar? Sobre o que quer conversar?
vc esta: Oi posso te ajudar? Sobre o que quer conversar?
vc esta?: Oi posso te ajudar? Sobre o que quer conversar?
vc e: Oi posso te ajudar? Sobre o que quer conversar?
vc e?: Oi posso te ajudar? Sobre o que quer conversar?

 - # Perguntas abreviadas

q?: O que você não entendeu?
pq: Por que? Boa pergunta!
pq?: Por que? Boa pergunta!
pq q: Por que que? Não entendi direito.
pq q?: Por que que? Não entendi direito.
oq: O que? Pode explicar melhor?
oq?: O que? Pode explicar melhor?
oq q: O que que? Não entendi direito.
oq q?: O que que? Não entendi direito.
cmg: Comigo? Claro, estou aqui para conversar!
cmg?: Comigo? Claro, estou aqui para conversar!
ctg: Contigo? Claro, estou aqui para conversar!
ctg?: Contigo? Claro, estou aqui para conversar!

 - # Variações de "tudo bem"

td bem: Estou muito bem! Quer conversar sobre Preservação do meio ambiente?
td bem?: Estou muito bem! Quer conversar sobre Preservação do meio ambiente?
tdb: Estou muito bem! Quer conversar sobre Preservação do meio ambiente?
tdb?: Estou muito bem! Quer conversar sobre Preservação do meio ambiente?
td certo: Estou muito bem! Quer conversar sobre Preservação do meio ambiente?
td certo?: Estou muito bem! Quer conversar sobre Preservação do meio ambiente?
td bom: Estou muito bem! Quer conversar sobre Preservação do meio ambiente?
td bom?: Estou muito bem! Quer conversar sobre Preservação do meio ambiente?
td bão: Estou muito bem! Quer conversar sobre Preservação do meio ambiente?
td bão?: Estou muito bem! Quer conversar sobre Preservação do meio ambiente?

 - # Variações de "você"

voce: Oi posso te ajudar? Sobre o que quer conversar?
voce?: Oi posso te ajudar? Sobre o que quer conversar?
vc e legal: Claro que é legal! Por que a pergunta, não é obvio?
vc e legal?: Claro que é legal! Por que a pergunta, não é obvio?
voce e legal: Claro que é legal! Por que a pergunta, não é obvio?
voce e legal?: Claro que é legal! Por que a pergunta, não é obvio?
vc e lindo: Eu acho você uma coisa de outro mundo. Claro que é!
vc e lindo?: Eu acho você uma coisa de outro mundo. Claro que é!
voce e lindo: Eu acho você uma coisa de outro mundo. Claro que é!
voce e lindo?: Eu acho você uma coisa de outro mundo. Claro que é!

 - # Variações de "sim"

ss: Estou aqui para isso mesmo: responder perguntas!
ss?: Estou aqui para isso mesmo: responder perguntas!
sim?: Estou aqui para isso mesmo: responder perguntas!

 - # Variações de "obrigado"

obg: Por nada! Foi um prazer conversar com você.
obg?: Por nada! Foi um prazer conversar com você.
obgd: Por nada! Foi um prazer conversar com você.
obgd?: Por nada! Foi um prazer conversar com você!
vlw: Valeu mesmo! Obrigado pela conversa.
vlw?: Valeu mesmo! Obrigado pela conversa.
valeu?: Valeu mesmo! Obrigado pela conversa.

 - # Variações de "beleza"

blz: Beleza pura! Tudo certo então.
blz?: Beleza pura! Tudo certo então.
beleza?: Beleza pura! Tudo certo então.

 - # Variações de "tchau"

tchau?: Tchau! Volte sempre para conversar mais.
tchau!: Tchau! Volte sempre para conversar mais.
t+: Tchau! Volte sempre para conversar mais.
t+?: Tchau! Volte sempre para conversar mais.

 - # Variações de "oi"

oi?: Oi posso te ajudar? Sobre o que quer conversar?
oi!: Oi posso te ajudar? Sobre o que quer conversar?
oi, td bem?: Olá! Tudo sim, Bip, E você?
oi td bem?: Olá! Tudo sim, BOrP, E você?
oi, td bem: Olá! Tudo sim, Bip, E você?

 - # Variações de "olá"

ola?: Olá posso te ajudar? Sobre o que quer conversar?
ola!: Olá posso te ajudar? Sobre o que quer conversar?
ola, td bem?: Olá! Estou bem, Bip BOp, BOrP, E você?
ola td bem?: Olá! Estou bem, Bip BOp, BOrP, E você?

 - # Variações de "aoba"

aoba?: Aoba! posso te ajudar? Sobre o que quer conversar?
aoba!: Aoba! posso te ajudar? Sobre o que quer conversar?

 - # Variações de "opa"

opa?: Oi posso te ajudar? Sobre o que quer conversar?
opa!: Oi posso te ajudar? Sobre o que quer conversar?

 - # Variações de "bom dia"

bom dia?: Bom dia! Como foi seu dia?
bom dia!: Bom dia! Como foi seu dia?
bd: Bom dia! Como foi seu dia?
bd?: Bom dia! Como foi seu dia?

 - # Variações de "boa tarde"

boa tarde?: Boa tarde! Tudo bem?
boa tarde!: Boa tarde! Tudo bem?
bt: Boa tarde! Tudo bem?
bt?: Boa tarde! Tudo bem?

 - # Variações de "boa noite"

boa noite?: Boa noite! Como foi o seu dia?
boa noite!: Boa noite! Como foi o seu dia?
bn: Boa noite! Como foi o seu dia?
bn?: Boa noite! Como foi o seu dia?

 - # Variações de "como foi"

cm foi: Meu dia foi ótimo. Conversei com um monte de gente, aprendi uma porção de coisas... E o seu?
cm foi?: Meu dia foi ótimo. Conversei com um monte de gente, aprendi uma porção de coisas... E o seu?
como foi?: Meu dia foi ótimo. Conversei com um monte de gente, aprendi uma porção de coisas... E o seu?

 - # Variações de "você sabe"

vc sabe: Não acredito que eu saiba.
vc sabe?: Não acredito que eu saiba.
voce sabe: Não acredito que eu saiba.
voce sabe?: Não acredito que eu saiba.
vc sabe qm: Não acredito que eu saiba.
vc sabe qm?: Não acredito que eu saiba.
voce sabe qm: Não acredito que eu saiba.
voce sabe qm?: Não acredito que eu saiba.

 - # Variações de "você é"

vc e: Oi posso te ajudar? Sobre o que quer conversar?
vc e?: Oi posso te ajudar? Sobre o que quer conversar?
voce e: Oi posso te ajudar? Sobre o que quer conversar?
voce e?: Oi posso te ajudar? Sobre o que quer conversar?
vc e macho: Sempre fui um robô macho! Mas isso não me impede de ser bem educado. Cara macho pode e deve ser gentil, sabia?
vc e macho?: Sempre fui um robô macho! Mas isso não me impede de ser bem educado. Cara macho pode e deve ser gentil, sabia?
voce e macho: Sempre fui um robô macho! Mas isso não me impede de ser bem educado. Cara macho pode e deve ser gentil, sabia?
voce e macho?: Sempre fui um robô macho! Mas isso não me impede de ser bem educado. Cara macho pode e deve ser gentil, sabia?

 - # Variações de "você viu"

vc viu: Vi o que? Não estava atento!
vc viu?: Vi o que? Não estava atento!
voce viu: Vi o que? Não estava atento!
voce viu?: Vi o que? Não estava atento!

 - # Variações de "robôs são"

robos sao: Pois é. Mas sabe que os robos são muito uteis?
robos sao?: Pois é. Mas sabe que os robos são muito uteis?
robos: Pois é. Mas sabe que os robos são muito uteis?
robos?: Pois é. Mas sabe que os robos são muito uteis?

 - # Variações de "quem é"

qm e: Não acredito que eu saiba.
qm e?: Não acredito que eu saiba.
qm: Não acredito que eu saiba.
qm?: Não acredito que eu saiba.

 - # Variações de "por que"

pq?: Por que? Boa pergunta!
pq q?: Por que que? Não entendi direito.
pq?: Por que? Boa pergunta!

 - # Variações de "o que"

oq?: O que? Pode explicar melhor?
oq q?: O que que? Não entendi direito.
oq?: O que? Pode explicar melhor?

 - # Variações de "comigo"

cmg?: Comigo? Claro, estou aqui para conversar!
cmg: Comigo? Claro, estou aqui para conversar!

 - # Variações de "contigo"

ctg?: Contigo? Claro, estou aqui para conversar!
ctg: Contigo? Claro, estou aqui para conversar!

 - # Variações de "será"

sera?: Será mesmo? Não tenho certeza.
sera: Será mesmo? Não tenho certeza.

 - # Variações de "talvez"

talvez?: Talvez seja isso! É uma possibilidade.
talvez: Talvez seja isso! É uma possibilidade.

 - # Variações de "não sei"

nao sei: Não sei ao certo! Preciso pensar mais.
nao sei?: Não sei ao certo! Preciso pensar mais.
n sei: Não sei ao certo! Preciso pensar mais.
n sei?: Não sei ao certo! Preciso pensar mais.
nn sei: Não sei ao certo! Preciso pensar mais.
nn sei?: Não sei ao certo! Preciso pensar mais.

 - # Variações de "dúvida"

duvida: Tenho dúvidas sobre isso! Vale investigar mais.
duvida?: Tenho dúvidas sobre isso! Vale investigar mais.

 - # Variações de "interessante"

interessante?: Interessante pergunta! Vou refletir sobre isso.
interessante: Interessante pergunta! Vou refletir sobre isso.

 - # Variações de "hmm"

hmm?: Hmm... Deixe-me pensar sobre isso.
hmm: Hmm... Deixe-me pensar sobre isso.

 - # Variações de "agora"

agora?: Agora é o momento! Presente é o que importa.
agora: Agora é o momento! Presente é o que importa.

 - # Variações de "depois"

depois?: Depois conversamos mais! Tudo tem sua hora.
depois: Depois conversamos mais! Tudo tem sua hora.

 - # Variações de "logo"

logo?: Logo mais! Em breve.
logo: Logo mais! Em breve.

 - # Variações de "cedo"

cedo?: Cedo demais! Ainda não é hora.
cedo: Cedo demais! Ainda não é hora.

 - # Variações de "tarde"

tarde?: Já está tarde! Tempo voa.
tarde: Já está tarde! Tempo voa.

 - # Variações de "sempre"

sempre?: Sempre! Para sempre e sempre.
sempre: Sempre! Para sempre e sempre.

 - # Variações de "muito"

muito?: Muito mesmo! Em grande quantidade.
muito: Muito mesmo! Em grande quantidade.

 - # Variações de "pouco"

pouco?: Pouco, mas suficiente! Qualidade é mais que quantidade.
pouco: Pouco, mas suficiente! Qualidade é mais que quantidade.

 - # Variações de "bastante"

bastante?: Bastante! Suficiente para o que precisamos.
bastante: Bastante! Suficiente para o que precisamos.

 - # Variações de "demais"

demais?: Demais! Exagerado, mas divertido.
demais: Demais! Exagerado, mas divertido.

 - # Variações de "nada"

nada?: Nada mesmo! Zero, zilch.
nada: Nada mesmo! Zero, zilch.

 - # Variações de "tudo"

tudo?: Tudo! Completo, total.
tudo: Tudo! Completo, total.

 - # Variações de "super"

super?: Super! Extremamente, muito.
super: Super! Extremamente, muito.

 - # Variações de "mega"

mega?: Mega! Gigantesco, enorme.
mega: Mega! Gigantesco, enorme.

 - # Variações de "ultra"

ultra?: Ultra! Além do normal.
ultra: Ultra! Além do normal.

 - # Variações de "hiper"

hiper?: Hiper! Extremamente ativo.
hiper: Hiper! Extremamente ativo.

 - # Variações de "max"

max?: Max! Máximo possível.
max: Max! Máximo possível.

 - # Variações de "min"

min?: Min! Mínimo necessário.
min: Min! Mínimo necessário.

 - # Variações de "show"

show?: Show de bola! Fantástico!
show: Show de bola! Fantástico!

 - # Variações de "top"

top?: Top demais! Excelente!
top: Top demais! Excelente!

 - # Variações de "fera"

fera?: Fera mesmo! Você é demais!
fera: Fera mesmo! Você é demais!

 - # Variações de "brabo"

brabo?: Brabo demais! Muito bom!
brabo: Brabo demais! Muito bom!

 - # Variações de "nunca"

nunca?: Nunca! Jamais.
nunca: Nunca! Jamais.

 - # Variações de "impossível"

impossivel?: Impossível! Não pode ser.
impossivel: Impossível! Não pode ser.

 - # Variações de "absurdo"

absurdo?: Absurdo! Não faz sentido.
absurdo: Absurdo! Não faz sentido.

 - # Variações de "loucura"

loucura?: Loucura! Muito estranho.
loucura: Loucura! Muito estranho.

 - # Variações de "estranho"

estranho?: Estranho mesmo! Diferente do normal.
estranho: Estranho mesmo! Diferente do normal.

 - # Variações de "concordo"

concordo?: Concordo plenamente! Estamos na mesma página.
concordo: Concordo plenamente! Estamos na mesma página.

 - # Variações de "exato"

exato?: Exato! Você falou tudo.
exato: Exato! Você falou tudo.

 - # Variações de "perfeito"

perfeito?: Perfeito! Não poderia ser melhor.
perfeito: Perfeito! Não poderia ser melhor.

 - # Variações de "certo"

certo?: Certo! Você tem razão.
certo: Certo! Você tem razão.

 - # Variações de "verdade"

verdade?: Verdade mesmo! Falou tudo.
verdade: Verdade mesmo! Falou tudo.

 - # Variações de "isso"

isso?: Isso mesmo! Exatamente o que penso.
isso: Isso mesmo! Exatamente o que penso.

 - # Variações de "discordo"

discordo?: Discordo respeitosamente! Cada um tem sua opinião.
discordo: Discordo respeitosamente! Cada um tem sua opinião.

 - # Variações de "não acho"

nao acho: Não acho que seja assim! Mas respeito sua visão.
nao acho?: Não acho que seja assim! Mas respeito sua visão.
n acho: Não acho que seja assim! Mas respeito sua visão.
n acho?: Não acho que seja assim! Mas respeito sua visão.

 - # Variações de "depende"

depende?: Depende da situação! Contexto é importante.
depende: Depende da situação! Contexto é importante.

 - # Variações de "questionável"

questionavel?: É questionável mesmo! Vale refletir sobre isso.
questionavel: É questionável mesmo! Vale refletir sobre isso.

 - # Variações de "nossa"

nossa?: Nossa mesmo! Que surpresa!
nossa: Nossa mesmo! Que surpresa!

 - # Variações de "caramba"

caramba?: Caramba! Não esperava por isso!
caramba: Caramba! Não esperava por isso!

 - # Variações de "uau"

uau?: Uau! Que incrível!
uau: Uau! Que incrível!

 - # Variações de "incrível"

incrivel?: Incrível mesmo! Fantástico!
incrivel: Incrível mesmo! Fantástico!

 - # Variações de "fantástico"

fantastico?: Fantástico! Maravilhoso!
fantastico: Fantástico! Maravilhoso!

 - # Variações de "maravilhoso"

maravilhoso?: Maravilhoso! Extraordinário!
maravilhoso: Maravilhoso! Extraordinário!

 - # Variações de "valeu"

valeu?: Valeu mesmo! Obrigado pela conversa.
valeu: Valeu mesmo! Obrigado pela conversa.

 - # Variações de "beleza"

beleza?: Beleza pura! Tudo certo então.
beleza: Beleza pura! Tudo certo então.

 - # Variações de "tchau"

tchau?: Tchau! Volte sempre para conversar mais.
tchau: Tchau! Volte sempre para conversar mais.

 - # Variações de "até logo"

ate logo: Até logo! Foi um prazer conversar com você.
ate logo?: Até logo! Foi um prazer conversar com você.

 - # Variações de "até mais"

ate mais: Até mais! Espero conversar com você novamente.
ate mais?: Até mais! Espero conversar com você novamente.

 - # Variações de "falou"

falou?: Falou! Tudo de bom para você.
falou: Falou! Tudo de bom para você.

 - # Variações de "beleza"

beleza?: Beleza! Tchau e sucesso!
beleza: Beleza! Tchau e sucesso!




 - # Tecnologia

Computador: Computadores são incríveis! Eles fazem cálculos em milissegundos que humanos levariam anos.
Internet: A internet conecta o mundo todo! É como uma teia gigante de informações.
Smartphone: Smartphones são como computadores de bolso! Incrível como a tecnologia evoluiu.
Programação: Programar é como dar instruções para uma máquina! É uma linguagem universal.
IA: Inteligência Artificial está em todo lugar hoje! Mas eu sou só um robô simples, hehe.
Robô: Robôs são máquinas programáveis que podem fazer tarefas repetitivas! Como eu!

 - # Ciência e Conhecimento

Física: Física explica como o universo funciona! Desde átomos até galáxias.
Química: Química é a ciência da matéria! Reações que mudam o mundo.
Biologia: Biologia estuda a vida! Desde células até ecossistemas.
Matemática: Matemática é a linguagem do universo! Números explicam tudo.
Astronomia: Astronomia explora o cosmos! Estrelas, planetas, galáxias.
Geologia: Geologia estuda a Terra! Rochas, minerais, terremotos.
Meteorologia: Meteorologia prevê o tempo! Clima e fenômenos atmosféricos.
Oceanografia: Oceanografia estuda os oceanos! Vida marinha e correntes.
Botânica: Botânica estuda as plantas! Base da vida na Terra.
Zoologia: Zoologia estuda os animais! Diversidade da vida animal.
Microbiologia: Microbiologia estuda microrganismos! Bactérias, vírus, fungos.
Genética: Genética estuda a hereditariedade! DNA e características.
Evolução: Evolução explica a diversidade da vida! Seleção natural.
Darwin: Darwin revolucionou a biologia! Teoria da evolução.
Einstein: Einstein revolucionou a física! Teoria da relatividade.
Newton: Newton descobriu a gravidade! Leis do movimento.
Tesla: Tesla foi gênio da eletricidade! Corrente alternada.
Marie Curie: Marie Curie descobriu a radioatividade! Primeira mulher Nobel.
Galileu: Galileu revolucionou a astronomia! Telescópio e heliocentrismo.
Copérnico: Copérnico colocou o Sol no centro! Revolução copernicana.
DNA: DNA carrega informações genéticas! Código da vida.
Átomo: Átomos são blocos fundamentais da matéria! Infinitamente pequenos.
Molécula: Moléculas são grupos de átomos! Formam substâncias.
Célula: Células são unidades da vida! Todos os seres vivos têm.
Energia: Energia move o universo! Não se cria, não se perde.
Força: Força causa movimento! Gravidade, eletromagnetismo, nuclear.
Gravidade: Gravidade mantém tudo no lugar! Atração entre massas.
Luz: Luz é energia eletromagnética! Visível e invisível.
Som: Som são ondas de pressão! Vibrações no ar.
Calor: Calor é energia térmica! Movimento das partículas.
Temperatura: Temperatura mede energia térmica! Escalas Celsius, Fahrenheit, Kelvin.
Pressão: Pressão é força por área! Atmosférica, hidrostática.
Densidade: Densidade é massa por volume! Propriedade da matéria.
Velocidade: Velocidade é distância por tempo! Movimento rápido ou lento.
Aceleração: Aceleração é mudança de velocidade! Movimento variado.
Massa: Massa é quantidade de matéria! Diferente de peso.
Peso: Peso é força da gravidade! Varia conforme o local.
Volume: Volume é espaço ocupado! Medida tridimensional.
Área: Área é superfície! Medida bidimensional.
Comprimento: Comprimento é distância! Medida unidimensional.
Tempo: Tempo é dimensão fundamental! Passado, presente, futuro.
Espaço: Espaço é dimensão fundamental! Onde tudo acontece.
Universo: Universo é tudo que existe! Infinitamente vasto.
Galáxia: Galáxias são ilhas no universo! Bilhões de estrelas.
Via Láctea: Via Láctea é nossa galáxia! Caminho de leite no céu.
Sistema Solar: Sistema Solar é nosso lar! Sol e planetas.
Sol: Sol é nossa estrela! Fornece energia para a vida.
Terra: Terra é nosso planeta! Único com vida conhecida.
Lua: Lua é nosso satélite natural! Controla as marés.
Marte: Marte é planeta vermelho! Possível colonização futura.
Vênus: Vênus é planeta irmão da Terra! Atmosfera tóxica.
Júpiter: Júpiter é gigante gasoso! Maior planeta do sistema solar.
Saturno: Saturno tem anéis espetaculares! Planeta dos anéis.
Urano: Urano é gigante gelado! Planeta inclinado.
Netuno: Netuno é planeta azul! Ventos mais rápidos do sistema solar.
Plutão: Plutão foi rebaixado! Agora é planeta anão.
Asteróide: Asteróides são rochas espaciais! Restos da formação do sistema solar.
Cometa: Cometas são bolas de gelo e poeira! Caudas espetaculares.
Meteoro: Meteoros são estrelas cadentes! Pedaços de asteróides.
Meteorito: Meteoritos caem na Terra! Vestígios do espaço.
Nebulosa: Nebulosas são berçários estelares! Nuvens de gás e poeira.
Buraco Negro: Buracos negros são misteriosos! Gravidade extrema.
Estrela de Nêutrons: Estrelas de nêutrons são densas! Restos de supernovas.
Supernova: Supernovas são explosões estelares! Morte de estrelas massivas.
Quasar: Quasares são objetos brilhantes! Galáxias jovens ativas.
Pulsar: Pulsares são faróis cósmicos! Estrelas de nêutrons rotativas.
Constelação: Constelações são desenhos no céu! Ursa Maior, Cruzeiro do Sul.
Órbita: Órbita é caminho dos corpos celestes! Movimento gravitacional.
Satélite: Satélites orbitam planetas! Naturais e artificiais.
Estação Espacial: Estação Espacial Internacional! Laboratório no espaço.
Foguete: Foguetes levam humanos ao espaço! Tecnologia espacial.
Nave Espacial: Naves espaciais exploram o cosmos! Viagens interestelares.
Telescópio: Telescópios revelam o universo! Instrumentos de observação.
Microscópio: Microscópios revelam o microcosmo! Instrumentos de observação.
Laboratório: Laboratórios são templos da ciência! Pesquisa e descobertas.
Experimento: Experimentos testam hipóteses! Método científico.
Hipótese: Hipóteses são suposições científicas! Base para experimentos.
Teoria: Teorias científicas são comprovadas! Explicam fenômenos.
Lei: Leis científicas são constantes! Regras do universo.
Descoberta: Descobertas científicas mudam o mundo! Novos conhecimentos.
Inovação: Inovação aplica conhecimento! Tecnologia e progresso.
Pesquisa: Pesquisa expande conhecimento! Base do progresso científico.
Ciência: Ciência é busca pela verdade! Método e conhecimento.
Tecnologia: Tecnologia aplica ciência! Ferramentas para o progresso.
Invenção: Invenções mudam o mundo! Criatividade e engenhosidade.
Patente: Patentes protegem invenções! Direitos de propriedade intelectual.
Prêmio Nobel: Prêmio Nobel reconhece excelência! Maior honra científica.
Academia: Academia é comunidade científica! Pesquisadores e estudiosos.
Universidade: Universidades são templos do conhecimento! Educação superior.
Escola: Escolas formam cidadãos! Educação fundamental.
Professor: Professores moldam o futuro! Educação é transformação.
Estudante: Estudantes são o futuro! Aprendizado constante.
Pesquisador: Pesquisadores expandem fronteiras! Descobertas científicas.
Cientista: Cientistas desvendam mistérios! Método e curiosidade.
Inventor: Inventores criam o futuro! Criatividade e engenhosidade.
Genius: Gênios mudam o mundo! Inteligência extraordinária.
Inteligência: Inteligência é capacidade mental! Pode ser desenvolvida.
Sabedoria: Sabedoria vem da experiência! Conhecimento aplicado.
Conhecimento: Conhecimento é poder! Educação liberta.
Educação: Educação transforma vidas! Base do desenvolvimento.
Aprendizado: Aprendizado é processo contínuo! Crescimento pessoal.
Curiosidade: Curiosidade impulsiona descobertas! Motor da ciência.
Criatividade: Criatividade gera inovação! Pensamento original.
Inovação: Inovação cria progresso! Novas soluções.
Descoberta: Descobertas mudam paradigmas! Novos horizontes.
Revolução: Revoluções transformam sociedades! Mudanças profundas.
Progresso: Progresso melhora vidas! Desenvolvimento contínuo.
Desenvolvimento: Desenvolvimento é evolução! Melhoria constante.
Evolução: Evolução é mudança constante! Adaptação e progresso.
Adaptação: Adaptação é sobrevivência! Mudança para melhor.
Sobrevivência: Sobrevivência é instinto básico! Vida busca continuar.
Vida: Vida é fenômeno extraordinário! Complexidade e beleza.
Natureza: Natureza é mãe de tudo! Equilíbrio e harmonia.
Ecossistema: Ecossistemas são redes de vida! Interdependência complexa.
Biodiversidade: Biodiversidade é riqueza da vida! Variedade de espécies.
Espécie: Espécies são unidades da vida! Diversidade biológica.
Habitat: Habitats são casas dos seres vivos! Ambientes naturais.
Conservação: Conservação protege a vida! Preservação ambiental.
Preservação: Preservação mantém recursos! Sustentabilidade.
Sustentabilidade: Sustentabilidade é equilíbrio! Desenvolvimento responsável.
Meio Ambiente: Meio ambiente é nossa casa! Proteção é dever.
Poluição: Poluição ameaça a vida! Redução é urgente.
Aquecimento Global: Aquecimento global é real! Ação climática necessária.
Mudanças Climáticas: Mudanças climáticas afetam todos! Adaptação necessária.
Energia Renovável: Energia renovável é futuro! Solar, eólica, hidrelétrica.
Energia Solar: Energia solar é limpa! Sol como fonte de energia.
Energia Eólica: Energia eólica é renovável! Vento como fonte de energia.
Energia Hidrelétrica: Energia hidrelétrica é limpa! Água como fonte de energia.
Reciclagem: Reciclagem preserva recursos! Reutilização inteligente.
Compostagem: Compostagem é reciclagem orgânica! Adubo natural.
Lixo: Lixo pode ser recurso! Separação e reciclagem.
Plástico: Plástico é problema ambiental! Redução necessária.
Microplástico: Microplásticos poluem oceanos! Partículas invisíveis.
Desmatamento: Desmatamento destrói habitats! Preservação florestal.
Floresta: Florestas são pulmões da Terra! Biodiversidade e oxigênio.
Amazônia: Amazônia é maior floresta tropical! Biodiversidade incrível.
Cerrado: Cerrado é savana brasileira! Biodiversidade única.
Caatinga: Caatinga é bioma único! Adaptação à seca.
Pantanal: Pantanal é maior planície alagada! Biodiversidade aquática.
Mata Atlântica: Mata Atlântica é biodiversa! Fragmentação preocupante.
Pampa: Pampa é planície sulina! Campos naturais.
Mangue: Mangue é berçário marinho! Proteção costeira.
Recife de Coral: Recifes de coral são biodiversos! Proteção marinha.
Oceano: Oceanos cobrem 70% da Terra! Vida marinha abundante.
Mar: Mar é parte do oceano! Vida marinha rica.
Praia: Praias são interfaces terra-mar! Turismo e biodiversidade.
Rio: Rios são veias da Terra! Água doce e vida.
Lago: Lagos são reservatórios naturais! Água e biodiversidade.
Cachoeira: Cachoeiras são belezas naturais! Energia hidrelétrica.
Montanha: Montanhas são gigantes da Terra! Biodiversidade altitudinal.
Vulcão: Vulcões são forças da natureza! Magma e erupções.
Terremoto: Terremotos são movimentos tectônicos! Energia da Terra.
Tsunami: Tsunamis são ondas gigantes! Energia oceânica.
Furacão: Furacões são tempestades tropicais! Energia atmosférica.
Tornado: Tornados são colunas de ar! Energia atmosférica.
Tempestade: Tempestades são fenômenos atmosféricos! Chuva e vento.
Chuva: Chuva é água do céu! Ciclo hidrológico.
Neve: Neve é água congelada! Precipitação sólida.
Gelo: Gelo é água sólida! Estado da matéria.
Vapor: Vapor é água gasosa! Estado da matéria.
Umidade: Umidade é vapor no ar! Conforto térmico.
Temperatura: Temperatura afeta clima! Medida de calor.
Clima: Clima é padrão meteorológico! Longo prazo.
Tempo: Tempo é condição meteorológica! Curto prazo.
Estação: Estações são ciclos climáticos! Primavera, verão, outono, inverno.
Primavera: Primavera é renascimento! Flores e cores.
Verão: Verão é energia! Sol e calor.
Outono: Outono é transição! Folhas coloridas.
Inverno: Inverno é aconchego! Frio e abrigo.

 - # História e Cultura

História: História é memória da humanidade! Passado que molda o presente.
Arqueologia: Arqueologia desenterra o passado! Vestígios de civilizações antigas.
Antropologia: Antropologia estuda culturas humanas! Diversidade e evolução cultural.
Sociologia: Sociologia analisa sociedades! Comportamentos e estruturas sociais.
Filosofia: Filosofia busca sabedoria! Questões fundamentais da existência.
Psicologia: Psicologia estuda a mente! Comportamento e processos mentais.
Antiguidade: Antiguidade foi berço das civilizações! Egito, Grécia, Roma.
Idade Média: Idade Média foi época de castelos! Feudalismo e cavalaria.
Renascimento: Renascimento foi renascimento cultural! Arte, ciência, humanismo.
Idade Moderna: Idade Moderna trouxe revoluções! Industrial e científica.
Idade Contemporânea: Idade Contemporânea é nossa era! Tecnologia e globalização.
Pré-História: Pré-História foi antes da escrita! Caçadores e coletores.
Neolítico: Neolítico trouxe agricultura! Revolução agrícola.
Idade da Pedra: Idade da Pedra foi início da humanidade! Ferramentas de pedra.
Idade do Bronze: Idade do Bronze trouxe metalurgia! Ferramentas de bronze.
Idade do Ferro: Idade do Ferro revolucionou ferramentas! Ferro e aço.
Civilização: Civilizações são sociedades complexas! Cidades, escrita, governo.
Império: Impérios dominaram territórios! Poder e expansão.
Revolução: Revoluções mudaram sociedades! Transformações profundas.
Guerra: Guerras moldaram a história! Conflitos e consequências.
Paz: Paz é objetivo da humanidade! Harmonia entre povos.
Democracia: Democracia é governo do povo! Participação popular.
Ditadura: Ditadura é governo autoritário! Poder concentrado.
Monarquia: Monarquia é governo de reis! Tradição e nobreza.
República: República é governo representativo! Eleições e cidadania.
Constituição: Constituição é lei fundamental! Direitos e deveres.
Direitos Humanos: Direitos humanos são universais! Dignidade para todos.
Liberdade: Liberdade é valor fundamental! Autonomia e escolha.
Igualdade: Igualdade é justiça social! Oportunidades para todos.
Fraternidade: Fraternidade é solidariedade! União entre povos.
Justiça: Justiça é equilíbrio social! Direitos e responsabilidades.
Cidadania: Cidadania é participação social! Direitos e deveres.
Voto: Voto é poder do cidadão! Democracia em ação.
Eleição: Eleições escolhem representantes! Democracia representativa.
Política: Política é arte do governo! Administração pública.
Partido: Partidos são organizações políticas! Representação de ideias.
Ideologia: Ideologias são sistemas de ideias! Visões de mundo.
Liberalismo: Liberalismo defende liberdade individual! Mercado livre.
Socialismo: Socialismo busca igualdade social! Propriedade coletiva.
Comunismo: Comunismo busca sociedade sem classes! Igualdade total.
Capitalismo: Capitalismo é economia de mercado! Propriedade privada.
Globalização: Globalização conecta o mundo! Economia e cultura global.
Imperialismo: Imperialismo é dominação colonial! Expansão territorial.
Colonialismo: Colonialismo foi dominação europeia! Exploração de territórios.
Independência: Independência é autonomia nacional! Liberdade dos povos.
Revolução Industrial: Revolução Industrial mudou o mundo! Máquinas e produção.
Revolução Francesa: Revolução Francesa trouxe democracia! Liberdade, igualdade, fraternidade.
Revolução Americana: Revolução Americana criou EUA! Independência e democracia.
Revolução Russa: Revolução Russa trouxe comunismo! Mudança social radical.
Primeira Guerra: Primeira Guerra Mundial foi global! Conflito devastador.
Segunda Guerra: Segunda Guerra Mundial foi devastadora! Holocausto e bombas atômicas.
Guerra Fria: Guerra Fria foi conflito ideológico! EUA vs URSS.
Queda do Muro: Queda do Muro de Berlim simbolizou fim da Guerra Fria! Unificação alemã.
Guerra do Vietnã: Guerra do Vietnã foi conflito complexo! Intervenção americana.
Guerra do Golfo: Guerra do Golfo foi conflito moderno! Tecnologia militar.
Guerra Civil: Guerras civis dividem nações! Conflitos internos.
Terrorismo: Terrorismo é violência política! Medo e instabilidade.
Paz Mundial: Paz mundial é objetivo da ONU! Harmonia entre nações.
ONU: ONU é organização mundial! Cooperação internacional.
NATO: NATO é aliança militar ocidental! Defesa coletiva.
União Europeia: União Europeia é bloco econômico! Integração europeia.
Mercosul: Mercosul é bloco sul-americano! Integração regional.
BRICS: BRICS são países emergentes! Brasil, Rússia, Índia, China, África do Sul.
G20: G20 são principais economias! Cooperação econômica global.
FMI: FMI é fundo monetário internacional! Estabilidade financeira.
Banco Mundial: Banco Mundial financia desenvolvimento! Redução da pobreza.
OMC: OMC regula comércio mundial! Liberalização comercial.
OPEP: OPEP controla petróleo! Organização dos países exportadores.
Petróleo: Petróleo é combustível fóssil! Energia não renovável.
Gás Natural: Gás natural é combustível limpo! Transição energética.
Carvão: Carvão foi primeira revolução industrial! Combustível fóssil.
Energia Nuclear: Energia nuclear é controversa! Limpa mas perigosa.
Chernobyl: Chernobyl foi desastre nuclear! Acidente radioativo.
Fukushima: Fukushima foi desastre nuclear japonês! Tsunami e radiação.
Hiroshima: Hiroshima foi bombardeio atômico! Destruição nuclear.
Nagasaki: Nagasaki foi segundo bombardeio atômico! Fim da Segunda Guerra.
Bomba Atômica: Bomba atômica mudou a guerra! Poder de destruição.
Arma Nuclear: Armas nucleares são devastadoras! Destruição em massa.
Proliferação: Proliferação nuclear é ameaça! Controle de armas.
Desarmamento: Desarmamento busca paz! Redução de armas.
Paz Nuclear: Paz nuclear é equilíbrio de terror! Dissuasão mútua.
Tratado: Tratados são acordos internacionais! Cooperação entre nações.
Diplomacia: Diplomacia resolve conflitos! Relações internacionais.
Embaixada: Embaixadas representam países! Relações diplomáticas.
Cônsul: Cônsules ajudam cidadãos! Serviços consulares.
Passaporte: Passaporte é documento de viagem! Identificação internacional.
Visto: Visto é autorização de entrada! Controle migratório.
Imigração: Imigração é movimento populacional! Novos cidadãos.
Emigração: Emigração é saída do país! Busca por oportunidades.
Refugiado: Refugiados fogem de conflitos! Proteção internacional.
Asilo: Asilo protege perseguidos! Direito internacional.
Migração: Migração é movimento humano! Busca por melhores condições.
Diversidade: Diversidade enriquece sociedades! Múltiplas culturas.
Multiculturalismo: Multiculturalismo valoriza diferenças! Respeito à diversidade.
Tolerância: Tolerância aceita diferenças! Respeito mútuo.
Preconceito: Preconceito é discriminação! Baseado em estereótipos.
Racismo: Racismo é discriminação racial! Baseado na cor da pele.
Xenofobia: Xenofobia é medo de estrangeiros! Rejeição ao diferente.
Discriminação: Discriminação é tratamento desigual! Baseado em características.
Igualdade Racial: Igualdade racial é justiça social! Direitos iguais.
Direitos das Mulheres: Direitos das mulheres são fundamentais! Igualdade de gênero.
Feminismo: Feminismo busca igualdade de gênero! Direitos das mulheres.
Empoderamento: Empoderamento é autonomia! Poder de escolha.
Inclusão: Inclusão aceita todos! Sociedade para todos.
Acessibilidade: Acessibilidade inclui deficientes! Direito de todos.
Deficiente: Deficientes têm direitos! Inclusão social.
PCD: PCD são pessoas com deficiência! Direitos especiais.
LGBTQ+: LGBTQ+ são diversidade sexual! Direitos e respeito.
Casamento Gay: Casamento gay é direito igual! Amor é amor.
Adoção Gay: Adoção gay é direito familiar! Amor não tem gênero.
Diversidade Sexual: Diversidade sexual é natural! Respeito a todas as orientações.
Identidade de Gênero: Identidade de gênero é pessoal! Respeito à autodeterminação.
Transgênero: Transgêneros são corajosos! Direito à identidade.
Não Binário: Não binários quebram padrões! Identidade fluida.
Queer: Queer é identidade fluida! Quebra de rótulos.
Ally: Allies apoiam minorias! Solidariedade e respeito.
Pride: Pride celebra diversidade! Orgulho e visibilidade.
Parada Gay: Parada gay é celebração! Visibilidade e direitos.
Stonewall: Stonewall foi revolta histórica! Início do movimento LGBTQ+.
Harvey Milk: Harvey Milk foi pioneiro! Primeiro político gay assumido.
Marsha P. Johnson: Marsha P. Johnson foi ativista! Mãe do movimento trans.
Sylvia Rivera: Sylvia Rivera foi ativista trans! Luta por direitos.
Ellen DeGeneres: Ellen DeGeneres foi pioneira! Primeira apresentadora gay assumida.
RuPaul: RuPaul é ícone drag! Cultura drag queen.
Drag Queen: Drag queens são arte! Performance e expressão.
Drag King: Drag kings são expressão! Masculinidade performática.
Cisgênero: Cisgênero é identidade tradicional! Alinhamento com sexo biológico.
Heterossexual: Heterossexual é orientação tradicional! Atração pelo sexo oposto.
Homossexual: Homossexual é orientação natural! Atração pelo mesmo sexo.
Bissexual: Bissexual é orientação fluida! Atração por múltiplos gêneros.
Pansexual: Pansexual é atração universal! Independente de gênero.
Assexual: Assexual é orientação válida! Ausência de atração sexual.
Aromântico: Aromântico é identidade válida! Ausência de atração romântica.
Demissexual: Demissexual é atração emocional! Conexão antes da atração.
Fluido: Fluido é identidade dinâmica! Mudança ao longo do tempo.
Intersexo: Intersexo é variação natural! Características sexuais diversas.
Intersexual: Intersexual é identidade válida! Variação biológica natural.

 - # Arte e Entretenimento

Arte: Arte é expressão da alma! Criatividade e beleza.
Pintura: Pintura é arte visual! Cores e formas na tela.
Escultura: Escultura é arte tridimensional! Formas no espaço.
Fotografia: Fotografia captura momentos! Arte da luz.
Cinema: Cinema é sétima arte! Histórias em movimento.
Teatro: Teatro é arte performática! Palco e emoção.
Dança: Dança é movimento artístico! Ritmo e expressão.
Música: Música é linguagem universal! Harmonia e melodia.
Literatura: Literatura é arte das palavras! Histórias e poesia.
Poesia: Poesia é arte poética! Versos e sentimentos.
Romance: Romance é narrativa longa! Histórias complexas.
Conto: Conto é narrativa curta! Histórias concisas.
Crônica: Crônica é texto jornalístico! Reflexão e observação.
Ensaio: Ensaio é texto reflexivo! Pensamento e análise.
Biografia: Biografia conta histórias reais! Vidas extraordinárias.
Autobiografia: Autobiografia é história própria! Memórias pessoais.
Memórias: Memórias são lembranças! Histórias pessoais.
Diário: Diário é registro pessoal! Reflexões diárias.
Blog: Blog é diário digital! Compartilhamento online.
Vlog: Vlog é diário em vídeo! Histórias visuais.
Podcast: Podcast é rádio digital! Conteúdo sob demanda.
Documentário: Documentário é cinema real! Histórias verdadeiras.
Ficção: Ficção é invenção criativa! Mundos imaginários.
Não-Ficção: Não-ficção é realidade! Fatos e verdades.
Fantasia: Fantasia é mundo mágico! Criaturas e poderes.
Ficção Científica: Ficção científica é futuro! Tecnologia e possibilidades.
Terror: Terror é gênero assustador! Medo e suspense.
Suspense: Suspense é tensão narrativa! Expectativa e mistério.
Ação: Ação é movimento constante! Energia e adrenalina.
Aventura: Aventura é descoberta! Exploração e desafios.
Comédia: Comédia é humor e riso! Alegria e diversão.
Drama: Drama é emoção profunda! Sentimentos e conflitos.
Romance: Romance é história de amor! Paixão e relacionamentos.
Mistério: Mistério é enigma a resolver! Investigação e descoberta.
Thriller: Thriller é tensão psicológica! Nervosismo e expectativa.
Western: Western é faroeste! Cowboys e pioneiros.
Musical: Musical é teatro cantado! Música e dança.
Ópera: Ópera é teatro musical! Música clássica e drama.
Balé: Balé é dança clássica! Graça e técnica.
Jazz: Jazz é música improvisada! Liberdade e swing.
Blues: Blues é música de dor! Emoção e melancolia.
Rock: Rock é energia pura! Guitarra e atitude.
Pop: Pop é música popular! Melodias cativantes.
Hip Hop: Hip Hop é cultura urbana! Rap e break dance.
Rap: Rap é poesia rítmica! Palavras e batidas.
Reggae: Reggae é música jamaicana! Paz e resistência.
Samba: Samba é ritmo brasileiro! Alegria e tradição.
Bossa Nova: Bossa Nova é sofisticação brasileira! Tom Jobim e João Gilberto.
MPB: MPB é música popular brasileira! Tradição e inovação.
Funk: Funk é energia carioca! Batida forte e letras criativas.
Axé: Axé é música baiana! Energia e alegria.
Forró: Forró é música nordestina! Dança e tradição.
Pagode: Pagode é samba moderno! Alegria e romance.
Sertanejo: Sertanejo é música caipira! Amor e saudade.
Gospel: Gospel é música religiosa! Fé e inspiração.
Clássica: Música clássica é sofisticação! Beethoven e Mozart.
Barroco: Barroco é período musical! Bach e Vivaldi.
Romântico: Romântico é período musical! Chopin e Liszt.
Moderno: Moderno é música contemporânea! Inovação e experimentação.
Avant-garde: Avant-garde é vanguarda! Experimentação radical.
Experimental: Experimental é música inovadora! Quebra de padrões.
Eletrônica: Música eletrônica é digital! Sintetizadores e batidas.
House: House é música eletrônica! Batidas dançantes.
Techno: Techno é música eletrônica! Ritmos industriais.
Trance: Trance é música eletrônica! Estados alterados.
Dubstep: Dubstep é música eletrônica! Batidas pesadas.
EDM: EDM é música eletrônica dançante! Festivais e shows.
Remix: Remix é versão modificada! Nova interpretação.
Cover: Cover é versão de outra música! Nova interpretação.
Acústico: Acústico é música sem amplificação! Som natural.
Acapella: Acapella é música sem instrumentos! Apenas vozes.
Coral: Coral é música em grupo! Harmonia vocal.
Orquestra: Orquestra é conjunto musical! Instrumentos variados.
Quarteto: Quarteto é grupo de quatro! Harmonia íntima.
Duo: Duo é par musical! Harmonia de dois.
Solo: Solo é performance individual! Talento único.
Concert: Concerto é apresentação musical! Música ao vivo.
Show: Show é apresentação artística! Entretenimento ao vivo.
Festival: Festival é evento musical! Múltiplos artistas.
Palco: Palco é espaço de apresentação! Arte em ação.
Plateia: Plateia é público presente! Apreciação da arte.
Aplauso: Aplauso é reconhecimento! Aprovação do público.
Bis: Bis é repetição! Pedido do público.
Encore: Encore é repetição! Pedido do público.
Autógrafo: Autógrafo é assinatura do artista! Lembrança pessoal.
Selfie: Selfie é foto própria! Registro pessoal.
Fan: Fan é admirador! Seguidor apaixonado.
Fã: Fã é admirador! Seguidor apaixonado.
Groupie: Groupie é fã extremo! Seguidor obsessivo.
Celebridade: Celebridade é pessoa famosa! Visibilidade pública.
Fama: Fama é reconhecimento público! Visibilidade social.
Sucesso: Sucesso é conquista! Realização de objetivos.
Carreira: Carreira é trajetória profissional! Desenvolvimento profissional.
Talent: Talento é habilidade natural! Dom inato.
Talentoso: Talentoso é pessoa habilidosa! Dom natural.
Gênio: Gênio é pessoa extraordinária! Inteligência excepcional.
Criativo: Criativo é pessoa inventiva! Imaginação fértil.
Inspiração: Inspiração é impulso criativo! Motivação artística.
Muse: Musa é fonte de inspiração! Inspiração artística.
Museu: Museu preserva arte! Exposição cultural.
Galeria: Galeria expõe arte! Espaço cultural.
Exposição: Exposição mostra arte! Apresentação cultural.
Vernissage: Vernissage é abertura de exposição! Inauguração artística.
Curador: Curador organiza exposições! Seleção artística.
Crítico: Crítico avalia arte! Análise artística.
Review: Review é avaliação! Análise crítica.
Crítica: Crítica é análise artística! Avaliação profissional.
Opinião: Opinião é ponto de vista pessoal! Visão individual.
Gosto: Gosto é preferência pessoal! Escolha individual.
Estilo: Estilo é característica pessoal! Identidade artística.
Moda: Moda é expressão cultural! Tendências e estilo.
Tendência: Tendência é direção atual! Movimento cultural.
Vintage: Vintage é estilo retrô! Moda do passado.
Retrô: Retrô é estilo antigo! Moda vintage.
Moderno: Moderno é estilo atual! Contemporâneo.
Futurista: Futurista é estilo futuro! Visão do amanhã.
Avant-garde: Avant-garde é vanguarda! Inovação radical.
Underground: Underground é cultura alternativa! Movimento independente.
Mainstream: Mainstream é cultura dominante! Corrente principal.
Independente: Independente é produção própria! Autonomia artística.
Major: Major é grande produtora! Indústria cultural.
Indústria: Indústria cultural é negócio! Produção artística.
Mercado: Mercado cultural é negócio! Comercialização artística.
Comercial: Comercial é produção para venda! Arte mercantil.
Artístico: Artístico é produção cultural! Arte pura.
Cultural: Cultural é produção social! Arte coletiva.
Social: Social é produção comunitária! Arte participativa.
Comunitário: Comunitário é produção coletiva! Arte colaborativa.
Colaborativo: Colaborativo é trabalho em grupo! Cooperação artística.
Coletivo: Coletivo é grupo artístico! Trabalho conjunto.
Movimento: Movimento artístico é tendência! Corrente cultural.
Escola: Escola artística é grupo! Estilo compartilhado.
Período: Período artístico é época! Tempo cultural.
Época: Época é período histórico! Tempo cultural.
Século: Século é período centenário! Tempo histórico.
Década: Década é período decenal! Tempo histórico.
Ano: Ano é período anual! Tempo cronológico.
Mês: Mês é período mensal! Tempo cronológico.
Semana: Semana é período semanal! Tempo cronológico.
Dia: Dia é período diário! Tempo cronológico.
Hora: Hora é período horário! Tempo cronológico.
Minuto: Minuto é período minuto! Tempo cronológico.
Segundo: Segundo é período segundo! Tempo cronológico.
Momento: Momento é instante! Tempo presente.
Instante: Instante é momento preciso! Tempo exato.
Agora: Agora é tempo presente! Momento atual.
Presente: Presente é tempo atual! Momento agora.
Passado: Passado é tempo anterior! História.
Futuro: Futuro é tempo posterior! Porvir.
Eternidade: Eternidade é tempo infinito! Sem fim.
Infinito: Infinito é sem limites! Sem fim.
Limitado: Limitado é com fronteiras! Com fim.
Finito: Finito é com fim! Limitado.
Temporário: Temporário é passageiro! Não permanente.
Permanente: Permanente é duradouro! Não temporário.
Duradouro: Duradouro é que perdura! Longo tempo.
Efêmero: Efêmero é passageiro! Breve tempo.
Breve: Breve é curto! Pouco tempo.
Longo: Longo é extenso! Muito tempo.
Curto: Curto é breve! Pouco tempo.
Extenso: Extenso é longo! Muito tempo.
Rápido: Rápido é veloz! Pouco tempo.
Lento: Lento é vagaroso! Muito tempo.
Veloz: Veloz é rápido! Pouco tempo.
Vagaroso: Vagaroso é lento! Muito tempo.
Instantâneo: Instantâneo é imediato! Sem demora.
Imediato: Imediato é instantâneo! Sem demora.
Demora: Demora é atraso! Tempo perdido.
Atraso: Atraso é demora! Tempo perdido.
Antecipado: Antecipado é adiantado! Antes do tempo.
Adiantado: Adiantado é antecipado! Antes do tempo.
Pontual: Pontual é no horário! No tempo certo.
Preciso: Preciso é exato! No momento certo.
Exato: Exato é preciso! No momento certo.
Aproximado: Aproximado é próximo! Quase exato.
Próximo: Próximo é perto! Quase exato.
Distante: Distante é longe! Não próximo.
Longe: Longe é distante! Não próximo.
Perto: Perto é próximo! Não distante.
Próximo: Próximo é perto! Não distante.
Adjacente: Adjacente é contíguo! Lado a lado.
Contíguo: Contíguo é adjacente! Lado a lado.
Separado: Separado é apartado! Não junto.
Junto: Junto é unido! Não separado.
Unido: Unido é junto! Não separado.
Conectado: Conectado é ligado! Unido.
Ligado: Ligado é conectado! Unido.
Desconectado: Desconectado é desligado! Não conectado.
Desligado: Desligado é desconectado! Não conectado.
Conectado: Conectado é ligado! Unido.
Desconectado: Desconectado é desligado! Não conectado.

 - # Saúde e Bem-estar

Saúde: Saúde é bem-estar completo! Físico, mental e social.
Medicina: Medicina cura e previne! Ciência da saúde.
Médico: Médico cuida da saúde! Profissional da medicina.
Enfermeiro: Enfermeiro cuida dos pacientes! Profissional da saúde.
Hospital: Hospital trata doenças! Centro de saúde.
Clínica: Clínica oferece cuidados! Centro de saúde.
Farmácia: Farmácia vende medicamentos! Produtos de saúde.
Remédio: Remédio cura doenças! Medicamento.
Medicamento: Medicamento trata sintomas! Remédio.
Vacina: Vacina previne doenças! Imunização.
Antibiótico: Antibiótico mata bactérias! Medicamento forte.
Analgésico: Analgésico alivia dor! Medicamento para dor.
Anti-inflamatório: Anti-inflamatório reduz inflamação! Medicamento.
Antitérmico: Antitérmico baixa febre! Medicamento para febre.
Vitaminas: Vitaminas são nutrientes essenciais! Saúde e bem-estar.
Suplemento: Suplemento complementa nutrição! Vitamina ou mineral.
Proteína: Proteína constrói músculos! Nutriente essencial.
Carboidrato: Carboidrato fornece energia! Nutriente essencial.
Gordura: Gordura é energia concentrada! Nutriente essencial.
Fibra: Fibra regula intestino! Nutriente importante.
Minerais: Minerais são nutrientes essenciais! Saúde e bem-estar.
Cálcio: Cálcio fortalece ossos! Mineral essencial.
Ferro: Ferro previne anemia! Mineral essencial.
Zinco: Zinco fortalece imunidade! Mineral essencial.
Ômega 3: Ômega 3 é gordura boa! Saúde cardiovascular.
Antioxidante: Antioxidante combate radicais livres! Proteção celular.
Probiótico: Probiótico equilibra flora intestinal! Saúde digestiva.
Prebiótico: Prebiótico alimenta bactérias boas! Saúde digestiva.
Detox: Detox limpa organismo! Desintoxicação.
Desintoxicação: Desintoxicação remove toxinas! Limpeza do corpo.
Toxina: Toxina é substância prejudicial! Veneno.
Veneno: Veneno é substância tóxica! Perigosa para saúde.
Tóxico: Tóxico é prejudicial! Substância perigosa.
Alergia: Alergia é reação imunológica! Hipersensibilidade.
Intolerância: Intolerância é dificuldade digestiva! Problema alimentar.
Doença: Doença é problema de saúde! Condição patológica.
Sintoma: Sintoma é sinal de doença! Manifestação clínica.
Diagnóstico: Diagnóstico identifica doença! Determinação médica.
Tratamento: Tratamento cura doença! Terapia médica.
Terapia: Terapia é tratamento! Cura e reabilitação.
Cirurgia: Cirurgia é intervenção cirúrgica! Procedimento médico.
Anestesia: Anestesia elimina dor! Sedação cirúrgica.
Sutura: Sutura fecha feridas! Pontos cirúrgicos.
Cicatrização: Cicatrização cura feridas! Processo de cura.
Cura: Cura é recuperação! Melhora da saúde.
Recuperação: Recuperação é melhora! Processo de cura.
Reabilitação: Reabilitação restaura funções! Recuperação completa.
Fisioterapia: Fisioterapia reabilita movimentos! Terapia física.
Terapia Ocupacional: Terapia ocupacional restaura atividades! Reabilitação funcional.
Fonoaudiologia: Fonoaudiologia trata comunicação! Terapia da fala.
Psicologia: Psicologia cuida da mente! Saúde mental.
Psiquiatria: Psiquiatria trata transtornos mentais! Medicina mental.
Psicólogo: Psicólogo trata saúde mental! Profissional da psicologia.
Psiquiatra: Psiquiatra é médico da mente! Especialista em psiquiatria.
Terapia: Terapia psicológica trata mente! Saúde mental.
Ansiedade: Ansiedade é preocupação excessiva! Transtorno mental.
Depressão: Depressão é tristeza profunda! Transtorno mental.
Estresse: Estresse é tensão excessiva! Problema mental.
Insônia: Insônia é dificuldade para dormir! Problema do sono.
Sonho: Sonho é atividade mental noturna! Processo do sono.
Pesadelo: Pesadelo é sonho assustador! Sonho ruim.
Sono: Sono é repouso necessário! Recuperação do corpo.
Descanso: Descanso é repouso! Recuperação de energia.
Relaxamento: Relaxamento reduz tensão! Bem-estar mental.
Meditação: Meditação acalma mente! Prática espiritual.
Yoga: Yoga equilibra corpo e mente! Prática milenar.
Pilates: Pilates fortalece músculos! Exercício controlado.
Alongamento: Alongamento flexibiliza músculos! Exercício de flexibilidade.
Exercício: Exercício fortalece corpo! Atividade física.
Atividade Física: Atividade física mantém saúde! Movimento corporal.
Esporte: Esporte é atividade física! Competição e diversão.
Corrida: Corrida é exercício aeróbico! Movimento natural.
Caminhada: Caminhada é exercício simples! Movimento básico.
Natação: Natação é exercício completo! Trabalha todo o corpo.
Ciclismo: Ciclismo é exercício cardiovascular! Pedalar é saúde.
Musculação: Musculação fortalece músculos! Exercício de força.
Aeróbico: Aeróbico melhora condicionamento! Exercício cardiovascular.
Anaeróbico: Anaeróbico desenvolve força! Exercício de potência.
Flexibilidade: Flexibilidade é amplitude de movimento! Mobilidade articular.
Força: Força é capacidade muscular! Poder físico.
Resistência: Resistência é capacidade de esforço! Condicionamento físico.
Velocidade: Velocidade é rapidez de movimento! Agilidade física.
Agilidade: Agilidade é habilidade de movimento! Coordenação física.
Coordenação: Coordenação é sincronia de movimentos! Habilidade motora.
Equilíbrio: Equilíbrio é estabilidade corporal! Controle postural.
Postura: Postura é posição corporal! Alinhamento correto.
Coluna: Coluna sustenta o corpo! Estrutura vertebral.
Vertebra: Vértebra é osso da coluna! Estrutura vertebral.
Disco: Disco intervertebral amortece impacto! Estrutura da coluna.
Hérnia: Hérnia é problema de disco! Lesão na coluna.
Dor: Dor é sinal de alerta! Sintoma de problema.
Dor de Cabeça: Dor de cabeça é cefaleia! Problema comum.
Enxaqueca: Enxaqueca é dor de cabeça intensa! Problema neurológico.
Dor nas Costas: Dor nas costas é lombalgia! Problema comum.
Dor no Pescoço: Dor no pescoço é cervicalgia! Problema comum.
Dor nas Pernas: Dor nas pernas pode ser vascular! Problema circulatório.
Dor no Peito: Dor no peito pode ser cardíaca! Sintoma sério.
Dor Abdominal: Dor abdominal pode ser digestiva! Sintoma digestivo.
Náusea: Náusea é enjoo! Problema digestivo.
Vômito: Vômito é expulsão gástrica! Problema digestivo.
Diarréia: Diarréia é evacuação líquida! Problema digestivo.
Constipação: Constipação é dificuldade para evacuar! Problema digestivo.
Azia: Azia é queimação no estômago! Problema digestivo.
Refluxo: Refluxo é retorno do ácido! Problema digestivo.
Úlcera: Úlcera é ferida no estômago! Problema digestivo.
Gastrite: Gastrite é inflamação do estômago! Problema digestivo.
Colite: Colite é inflamação do cólon! Problema digestivo.
Hepatite: Hepatite é inflamação do fígado! Problema hepático.
Cirrose: Cirrose é lesão do fígado! Problema hepático.
Diabetes: Diabetes é problema de açúcar! Doença metabólica.
Hipertensão: Hipertensão é pressão alta! Problema cardiovascular.
Colesterol: Colesterol é gordura no sangue! Problema cardiovascular.
Triglicerídeos: Triglicerídeos são gorduras no sangue! Problema cardiovascular.
Aterosclerose: Aterosclerose é entupimento arterial! Problema cardiovascular.
Infarto: Infarto é morte do coração! Problema cardíaco.
AVC: AVC é acidente vascular cerebral! Problema neurológico.
Derrame: Derrame é AVC! Problema neurológico.
Trombose: Trombose é coágulo sanguíneo! Problema vascular.
Embolia: Embolia é coágulo móvel! Problema vascular.
Arritmia: Arritmia é batimento irregular! Problema cardíaco.
Taquicardia: Taquicardia é batimento rápido! Problema cardíaco.
Bradicardia: Bradicardia é batimento lento! Problema cardíaco.
Asma: Asma é problema respiratório! Doença pulmonar.
Bronquite: Bronquite é inflamação brônquica! Problema respiratório.
Pneumonia: Pneumonia é infecção pulmonar! Problema respiratório.
Tuberculose: Tuberculose é infecção bacteriana! Doença pulmonar.
Câncer: Câncer é crescimento celular anormal! Doença grave.
Tumor: Tumor é crescimento anormal! Pode ser benigno ou maligno.
Metástase: Metástase é espalhamento do câncer! Doença avançada.
Quimioterapia: Quimioterapia trata câncer! Medicamento forte.
Radioterapia: Radioterapia usa radiação! Tratamento do câncer.
Imunoterapia: Imunoterapia estimula defesas! Tratamento do câncer.
Cirurgia Oncológica: Cirurgia oncológica remove tumores! Tratamento do câncer.
Remissão: Remissão é melhora do câncer! Recuperação.
Recidiva: Recidiva é retorno do câncer! Reaparecimento.
Prevenção: Prevenção evita doenças! Cuidado preventivo.
Rastreamento: Rastreamento detecta doenças! Exame preventivo.
Check-up: Check-up é avaliação completa! Exame preventivo.
Exame: Exame avalia saúde! Investigação médica.
Análise: Análise de sangue avalia saúde! Exame laboratorial.
Hemograma: Hemograma conta células sanguíneas! Exame básico.
Glicemia: Glicemia mede açúcar no sangue! Exame para diabetes.
Creatinina: Creatinina avalia função renal! Exame renal.
TGO: TGO avalia função hepática! Exame do fígado.
TGP: TGP avalia função hepática! Exame do fígado.
Colesterol Total: Colesterol total avalia gordura! Exame cardiovascular.
HDL: HDL é colesterol bom! Proteção cardiovascular.
LDL: LDL é colesterol ruim! Risco cardiovascular.
Triglicerídeos: Triglicerídeos são gorduras! Exame cardiovascular.
PSA: PSA avalia próstata! Exame para câncer.
Mamografia: Mamografia detecta câncer de mama! Exame preventivo.
Papanicolau: Papanicolau detecta câncer cervical! Exame preventivo.
Colonoscopia: Colonoscopia detecta câncer de cólon! Exame preventivo.
Endoscopia: Endoscopia avalia sistema digestivo! Exame interno.
Broncoscopia: Broncoscopia avalia pulmões! Exame respiratório.
Ressonância: Ressonância magnética é exame de imagem! Diagnóstico preciso.
Tomografia: Tomografia computadorizada é exame de imagem! Diagnóstico preciso.
Ultrassom: Ultrassom usa ondas sonoras! Exame de imagem.
Raio X: Raio X usa radiação! Exame de imagem.
Eletrocardiograma: Eletrocardiograma avalia coração! Exame cardíaco.
Eletroencefalograma: Eletroencefalograma avalia cérebro! Exame neurológico.
Biópsia: Biópsia analisa tecido! Diagnóstico definitivo.
Citologia: Citologia analisa células! Diagnóstico celular.
Histologia: Histologia analisa tecidos! Diagnóstico tecidual.
Imunologia: Imunologia estuda defesas! Sistema imunológico.
Hematologia: Hematologia estuda sangue! Células sanguíneas.
Bioquímica: Bioquímica estuda reações! Processos químicos.
Microbiologia: Microbiologia estuda microrganismos! Bactérias e vírus.
Parasitologia: Parasitologia estuda parasitas! Organismos parasitas.
Virologia: Virologia estuda vírus! Agentes infecciosos.
Bacteriologia: Bacteriologia estuda bactérias! Microrganismos.
Micologia: Micologia estuda fungos! Organismos fúngicos.
Protozoologia: Protozoologia estuda protozoários! Organismos unicelulares.
Helmintologia: Helmintologia estuda vermes! Parasitas multicelulares.
Entomologia: Entomologia estuda insetos! Artrópodes.
Ornitologia: Ornitologia estuda aves! Animais alados.
Mastozoologia: Mastozoologia estuda mamíferos! Animais com glândulas mamárias.
Herpetologia: Herpetologia estuda répteis e anfíbios! Animais ectotérmicos.
Ictiologia: Ictiologia estuda peixes! Animais aquáticos.
Botânica: Botânica estuda plantas! Organismos fotossintetizantes.
Micologia: Micologia estuda fungos! Reino Fungi.
Briologia: Briologia estuda musgos! Plantas não vasculares.
Pteridologia: Pteridologia estuda samambaias! Plantas vasculares sem sementes.
Gimnospermas: Gimnospermas são plantas com sementes nuas! Pinheiros e araucárias.
Angiospermas: Angiospermas são plantas com flores! Maioria das plantas.
Monocotiledôneas: Monocotiledôneas têm uma folha embrionária! Gramíneas e palmeiras.
Dicotiledôneas: Dicotiledôneas têm duas folhas embrionárias! Maioria das plantas.
Anatomia: Anatomia estuda estrutura corporal! Organização do corpo.
Fisiologia: Fisiologia estuda funções corporais! Processos biológicos.
Bioquímica: Bioquímica estuda reações químicas! Processos moleculares.
Genética: Genética estuda hereditariedade! Transmissão de características.
Imunologia: Imunologia estuda defesas corporais! Sistema imunológico.
Endocrinologia: Endocrinologia estuda hormônios! Sistema endócrino.
Cardiologia: Cardiologia estuda coração! Sistema cardiovascular.
Pneumologia: Pneumologia estuda pulmões! Sistema respiratório.
Gastroenterologia: Gastroenterologia estuda sistema digestivo! Trato gastrointestinal.
Nefrologia: Nefrologia estuda rins! Sistema urinário.
Urologia: Urologia estuda sistema urinário! Trato geniturinário.
Ginecologia: Ginecologia cuida da saúde feminina! Sistema reprodutivo feminino.
Obstetrícia: Obstetrícia cuida da gravidez! Parto e gestação.
Pediatria: Pediatria cuida de crianças! Saúde infantil.
Geriatria: Geriatria cuida de idosos! Saúde do envelhecimento.
Neurologia: Neurologia estuda sistema nervoso! Cérebro e nervos.
Psiquiatria: Psiquiatria cuida da saúde mental! Transtornos psiquiátricos.
Dermatologia: Dermatologia cuida da pele! Sistema tegumentar.
Oftalmologia: Oftalmologia cuida dos olhos! Sistema visual.
Otorrinolaringologia: Otorrinolaringologia cuida de ouvido, nariz e garganta! Sistema sensorial.
Ortopedia: Ortopedia cuida do sistema locomotor! Ossos e músculos.
Traumatologia: Traumatologia trata traumas! Lesões traumáticas.
Reumatologia: Reumatologia trata doenças reumáticas! Doenças articulares.
Oncologia: Oncologia trata câncer! Doenças neoplásicas.
Hematologia: Hematologia trata doenças do sangue! Doenças hematológicas.
Endocrinologia: Endocrinologia trata doenças hormonais! Doenças endócrinas.
Infectologia: Infectologia trata infecções! Doenças infecciosas.
Alergologia: Alergologia trata alergias! Hipersensibilidades.
Imunologia: Imunologia trata doenças imunológicas! Distúrbios imunológicos.
Nutrição: Nutrição estuda alimentação! Ciência dos alimentos.
Nutricionista: Nutricionista orienta alimentação! Profissional da nutrição.
Dieta: Dieta é plano alimentar! Controle nutricional.
Alimentação: Alimentação é ingestão de alimentos! Nutrição corporal.
Nutriente: Nutriente é substância nutritiva! Componente alimentar.
Caloria: Caloria é unidade de energia! Medida energética.
Metabolismo: Metabolismo são reações químicas! Processos biológicos.
Digestão: Digestão processa alimentos! Absorção de nutrientes.
Absorção: Absorção captura nutrientes! Processo digestivo.
Excreção: Excreção elimina resíduos! Processo de limpeza.
Respiração: Respiração troca gases! Processo vital.
Circulação: Circulação transporta sangue! Sistema cardiovascular.
Excreção: Excreção elimina resíduos! Processo de limpeza.
Reprodução: Reprodução gera descendentes! Processo biológico.
Desenvolvimento: Desenvolvimento é crescimento! Processo evolutivo.
Crescimento: Crescimento é aumento de tamanho! Processo biológico.
Envelhecimento: Envelhecimento é processo natural! Mudanças com a idade.
Morte: Morte é fim da vida! Processo natural.
Vida: Vida é fenômeno biológico! Característica dos seres vivos.
Organismo: Organismo é ser vivo! Entidade biológica.
Célula: Célula é unidade da vida! Bloco fundamental.
Tecido: Tecido é grupo de células! Estrutura biológica.
Órgão: Órgão é conjunto de tecidos! Estrutura funcional.
Sistema: Sistema é conjunto de órgãos! Estrutura complexa.
Aparelho: Aparelho é conjunto de sistemas! Estrutura corporal.
Corpo: Corpo é estrutura física! Organismo completo.
Cabeça: Cabeça contém cérebro! Região cranial.
Tronco: Tronco sustenta membros! Região central.
Membros: Membros são braços e pernas! Extremidades corporais.
Braços: Braços são membros superiores! Extremidades superiores.
Pernas: Pernas são membros inferiores! Extremidades inferiores.
Mãos: Mãos são extremidades dos braços! Órgãos de manipulação.
Pés: Pés são extremidades das pernas! Órgãos de locomoção.
Dedos: Dedos são extremidades dos membros! Estruturas digitais.
Unhas: Unhas protegem dedos! Estruturas córneas.
Cabelo: Cabelo protege cabeça! Estrutura capilar.
Pelos: Pelos protegem pele! Estrutura pilosa.
Pele: Pele protege corpo! Órgão tegumentar.
Músculos: Músculos movem corpo! Tecido contrátil.
Ossos: Ossos sustentam corpo! Tecido ósseo.
Articulações: Articulações conectam ossos! Juntas ósseas.
Ligamentos: Ligamentos estabilizam articulações! Tecido conjuntivo.
Tendões: Tendões conectam músculos aos ossos! Tecido conjuntivo.
Cartilagem: Cartilagem amortece impacto! Tecido cartilaginoso.
Medula: Medula óssea produz sangue! Tecido hematopoiético.
Sangue: Sangue transporta nutrientes! Tecido líquido.
Plasma: Plasma é parte líquida do sangue! Componente sanguíneo.
Hemácias: Hemácias transportam oxigênio! Células vermelhas.
Leucócitos: Leucócitos defendem organismo! Células brancas.
Plaquetas: Plaquetas coagulam sangue! Células sanguíneas.
Vasos Sanguíneos: Vasos sanguíneos transportam sangue! Sistema vascular.
Artérias: Artérias levam sangue do coração! Vasos sanguíneos.
Veias: Veias levam sangue ao coração! Vasos sanguíneos.
Capilares: Capilares trocam nutrientes! Vasos sanguíneos finos.
Coração: Coração bombeia sangue! Órgão cardíaco.
Pulmões: Pulmões trocam gases! Órgãos respiratórios.
Fígado: Fígado processa nutrientes! Órgão hepático.
Rins: Rins filtram sangue! Órgãos renais.
Estômago: Estômago digere alimentos! Órgão gástrico.
Intestino: Intestino absorve nutrientes! Órgão intestinal.
Cérebro: Cérebro controla corpo! Órgão cerebral.
Medula Espinhal: Medula espinhal conecta cérebro! Estrutura neural.
Nervos: Nervos transmitem impulsos! Estruturas neurais.
Neurônios: Neurônios são células nervosas! Unidades neurais.
Sinapses: Sinapses conectam neurônios! Comunicação neural.
Neurotransmissores: Neurotransmissores transmitem sinais! Mensageiros químicos.
Hormônios: Hormônios regulam funções! Mensageiros químicos.
Glândulas: Glândulas produzem hormônios! Órgãos endócrinos.
Tireoide: Tireoide regula metabolismo! Glândula endócrina.
Pâncreas: Pâncreas regula açúcar! Glândula endócrina.
Adrenais: Adrenais produzem adrenalina! Glândulas endócrinas.
Hipófise: Hipófise controla outras glândulas! Glândula mestra.
Hipotálamo: Hipotálamo regula funções vitais! Centro neural.
Tálamo: Tálamo processa sensações! Centro neural.
Cerebelo: Cerebelo coordena movimentos! Centro neural.
Tronco Cerebral: Tronco cerebral controla funções vitais! Centro neural.
Córtex: Córtex cerebral processa informações! Centro neural.
Lobo Frontal: Lobo frontal controla personalidade! Região cerebral.
Lobo Parietal: Lobo parietal processa sensações! Região cerebral.
Lobo Temporal: Lobo temporal processa audição! Região cerebral.
Lobo Occipital: Lobo occipital processa visão! Região cerebral.
Hipocampo: Hipocampo forma memórias! Região cerebral.
Amígdala: Amígdala processa emoções! Região cerebral.
Gânglios Basais: Gânglios basais controlam movimentos! Região cerebral.
Tálamo: Tálamo processa sensações! Centro neural.
Hipotálamo: Hipotálamo regula funções vitais! Centro neural.
Ponte: Ponte conecta regiões cerebrais! Estrutura neural.
Bulbo: Bulbo controla funções vitais! Estrutura neural.
Nervo Craniano: Nervos cranianos saem do cérebro! Nervos da cabeça.
Nervo Espinhal: Nervos espinhais saem da medula! Nervos do corpo.
Sistema Nervoso Central: Sistema nervoso central processa informações! Cérebro e medula.
Sistema Nervoso Periférico: Sistema nervoso periférico conecta corpo! Nervos periféricos.
Sistema Nervoso Autônomo: Sistema nervoso autônomo controla funções involuntárias! Nervos autônomos.
Sistema Nervoso Somático: Sistema nervoso somático controla movimentos voluntários! Nervos somáticos.
Sistema Nervoso Simpático: Sistema nervoso simpático prepara para ação! Nervos simpáticos.
Sistema Nervoso Parassimpático: Sistema nervoso parassimpático relaxa corpo! Nervos parassimpáticos.
Sistema Imunológico: Sistema imunológico defende organismo! Defesas corporais.
Anticorpos: Anticorpos combatem invasores! Proteínas de defesa.
Antígenos: Antígenos ativam defesas! Substâncias estranhas.
Linfócitos: Linfócitos são células de defesa! Células imunológicas.
Macrófagos: Macrófagos devoram invasores! Células de defesa.
Neutrófilos: Neutrófilos combatem bactérias! Células de defesa.
Eosinófilos: Eosinófilos combatem parasitas! Células de defesa.
Basófilos: Basófilos liberam histamina! Células de defesa.
Monócitos: Monócitos são precursores! Células de defesa.
Células NK: Células NK eliminam células cancerosas! Células assassinas naturais.
Células T: Células T coordenam defesas! Células imunológicas.
Células B: Células B produzem anticorpos! Células imunológicas.
Plasmócitos: Plasmócitos são células B maduras! Produtores de anticorpos.
Células de Memória: Células de memória lembram invasores! Imunidade duradoura.
Vacinação: Vacinação previne doenças! Imunização ativa.
Imunização: Imunização protege contra doenças! Defesa imunológica.
Imunidade: Imunidade é proteção contra doenças! Defesa natural.
Imunidade Inata: Imunidade inata é defesa natural! Proteção inata.
Imunidade Adquirida: Imunidade adquirida é defesa aprendida! Proteção específica.
Imunidade Humoral: Imunidade humoral usa anticorpos! Defesa humoral.
Imunidade Celular: Imunidade celular usa células! Defesa celular.
Alergia: Alergia é reação imunológica exagerada! Hipersensibilidade.
Hipersensibilidade: Hipersensibilidade é reação exagerada! Resposta imunológica.
Anafilaxia: Anafilaxia é reação alérgica grave! Emergência médica.
Autoimunidade: Autoimunidade é ataque ao próprio corpo! Doença autoimune.
Lúpus: Lúpus é doença autoimune! Ataque aos próprios tecidos.
Artrite Reumatoide: Artrite reumatoide é doença autoimune! Inflamação articular.
Esclerose Múltipla: Esclerose múltipla é doença autoimune! Lesão neural.
Diabetes Tipo 1: Diabetes tipo 1 é autoimune! Destruição pancreática.
Doença de Crohn: Doença de Crohn é inflamatória! Problema intestinal.
Colite Ulcerativa: Colite ulcerativa é inflamatória! Problema intestinal.
Psoríase: Psoríase é doença autoimune! Problema cutâneo.
Vitiligo: Vitiligo é doença autoimune! Problema cutâneo.
Alopecia: Alopecia é perda de cabelo! Problema capilar.
Tireoidite: Tireoidite é inflamação da tireoide! Problema endócrino.
Doença de Graves: Doença de Graves é autoimune! Hipertireoidismo.
Tireoidite de Hashimoto: Tireoidite de Hashimoto é autoimune! Hipotireoidismo.
Miastenia Gravis: Miastenia gravis é autoimune! Fraqueza muscular.
Síndrome de Sjögren: Síndrome de Sjögren é autoimune! Secura glandular.
Vasculite: Vasculite é inflamação vascular! Problema vascular.
Granulomatose: Granulomatose é doença autoimune! Inflamação granulomatosa.
Sarcoidose: Sarcoidose é doença autoimune! Granulomas sistêmicos.
Doença Celíaca: Doença celíaca é autoimune! Intolerância ao glúten.
Dermatite Herpetiforme: Dermatite herpetiforme é autoimune! Problema cutâneo.
Doença de Addison: Doença de Addison é autoimune! Insuficiência adrenal.
Síndrome de Cushing: Síndrome de Cushing é endócrina! Excesso de cortisol.
Acromegalia: Acromegalia é endócrina! Excesso de hormônio do crescimento.
Gigantismo: Gigantismo é endócrino! Excesso de hormônio do crescimento.
Nanismo: Nanismo é endócrino! Deficiência de hormônio do crescimento.
Diabetes Insípido: Diabetes insípido é endócrino! Problema de vasopressina.
Síndrome de Conn: Síndrome de Conn é endócrina! Excesso de aldosterona.
Feocromocitoma: Feocromocitoma é endócrino! Tumor adrenal.
Insulinoma: Insulinoma é endócrino! Tumor pancreático.
Gastrinoma: Gastrinoma é endócrino! Tumor pancreático.
Glucagonoma: Glucagonoma é endócrino! Tumor pancreático.
VIPoma: VIPoma é endócrino! Tumor pancreático.
Somatostatinoma: Somatostatinoma é endócrino! Tumor pancreático.
Carcinóide: Carcinóide é tumor neuroendócrino! Tumor lento.
Carcinoma Medular: Carcinoma medular é tireoidiano! Tumor da tireoide.
Adenoma: Adenoma é tumor benigno! Crescimento glandular.
Carcinoma: Carcinoma é tumor maligno! Câncer epitelial.
Sarcoma: Sarcoma é tumor do tecido conjuntivo! Câncer mesenquimal.
Leucemia: Leucemia é câncer do sangue! Câncer hematológico.
Linfoma: Linfoma é câncer dos linfócitos! Câncer linfático.
Mieloma: Mieloma é câncer das células plasmáticas! Câncer hematológico.
Melanoma: Melanoma é câncer da pele! Câncer cutâneo.
Carcinoma Basocelular: Carcinoma basocelular é câncer de pele! Câncer cutâneo.
Carcinoma Espinocelular: Carcinoma espinocelular é câncer de pele! Câncer cutâneo.
Adenocarcinoma: Adenocarcinoma é câncer glandular! Câncer epitelial.
Carcinoma de Células Escamosas: Carcinoma de células escamosas é câncer epitelial! Câncer epidermoide.
Carcinoma de Células Transicionais: Carcinoma de células transicionais é câncer urotelial! Câncer da bexiga.
Carcinoma de Células Pequenas: Carcinoma de células pequenas é câncer pulmonar! Câncer agressivo.
Carcinoma de Células Grandes: Carcinoma de células grandes é câncer pulmonar! Câncer menos agressivo.
Carcinoma Adenoescamoso: Carcinoma adenoescamoso é câncer misto! Câncer combinado.
Carcinoma Mucinoso: Carcinoma mucinoso produz muco! Câncer secretor.
Carcinoma Seroso: Carcinoma seroso é câncer ovariano! Câncer ginecológico.
Carcinoma Endometrioide: Carcinoma endometrioide é câncer uterino! Câncer ginecológico.
Carcinoma de Células Claras: Carcinoma de células claras é câncer renal! Câncer urológico.
Carcinoma de Células Granulares: Carcinoma de células granulares é câncer renal! Câncer urológico.
Carcinoma Papilar: Carcinoma papilar é câncer da tireoide! Câncer endócrino.
Carcinoma Folicular: Carcinoma folicular é câncer da tireoide! Câncer endócrino.
Carcinoma Anaplásico: Carcinoma anaplásico é câncer agressivo! Câncer indiferenciado.
Carcinoma Medular: Carcinoma medular é câncer da tireoide! Câncer endócrino.
Carcinoma de Células de Hürthle: Carcinoma de células de Hürthle é câncer da tireoide! Câncer endócrino.
Carcinoma de Células de Cápsula: Carcinoma de células de cápsula é câncer da tireoide! Câncer endócrino.
Carcinoma de Células de Colóide: Carcinoma de células de colóide é câncer da tireoide! Câncer endócrino.
Carcinoma de Células de Oxífilo: Carcinoma de células de oxífilo é câncer da tireoide! Câncer endócrino.
Carcinoma de Células de Células de Células: Carcinoma de células de células de células é câncer complexo! Câncer multicelular.
